the	politics
of	science
and	culture
to	sports
a	biology
in	environment
for	sports
is	geography
on	biology
that	culture
by	environment
this	politics
with	geography
i	politics
you	environment
it	biology
not	politics
or	biology
be	culture
are	sports
from	religion
at	geography
as	culture
your	religion
all	environment
have	biology
new	religion
more	sports
an	science
was	culture
we	religion
will	science
home	politics
can	culture
us	environment
about	religion
if	religion
page	geography
my	sports
has	biology
search	sports
free	biology
but	geography
our	science
one	sports
other	culture
do	science
no	science
information	biology
time	politics
they	religion
site	religion
he	culture
up	geography
may	politics
what	politics
which	culture
their	politics
news	culture
out	science
use	environment
any	politics
there	geography
see	culture
only	biology
so	geography
his	geography
when	science
contact	culture
here	religion
business	religion
who	politics
web	biology
also	science
now	sports
help	religion
get	science
pm	environment
view	science
online	science
c	culture
e	science
first	culture
am	biology
been	science
would	environment
how	environment
were	environment
me	biology
s	sports
services	politics
some	sports
these	religion
click	geography
its	religion
like	sports
service	culture
x	culture
than	environment
find	biology
price	sports
date	geography
back	politics
top	science
people	politics
had	biology
list	religion
name	geography
just	politics
over	politics
state	culture
year	geography
day	science
into	religion
email	geography
two	culture
health	religion
n	geography
world	politics
re	culture
next	environment
used	politics
go	science
b	culture
work	science
last	religion
most	sports
products	religion
music	biology
buy	sports
data	religion
make	sports
them	religion
should	politics
product	politics
system	religion
post	biology
her	geography
city	environment
t	culture
add	biology
policy	religion
number	culture
such	geography
please	politics
available	biology
copyright	biology
support	sports
message	sports
after	politics
best	geography
software	science
then	geography
jan	culture
good	science
video	biology
well	culture
d	biology
where	science
info	religion
rights	environment
public	culture
books	biology
high	sports
school	religion
through	geography
m	biology
each	geography
links	religion
she	environment
review	culture
years	sports
order	sports
very	culture
privacy	environment
book	sports
items	science
company	religion
r	geography
read	environment
group	environment
sex	sports
need	religion
many	geography
user	religion
said	politics
de	biology
does	religion
set	biology
under	sports
general	politics
research	religion
university	culture
january	biology
mail	culture
full	sports
map	religion
reviews	biology
program	culture
life	biology
know	culture
games	science
way	environment
days	religion
management	sports
p	politics
part	politics
could	biology
great	biology
united	biology
hotel	religion
real	politics
f	biology
item	biology
international	religion
center	environment
ebay	biology
must	sports
store	geography
travel	culture
comments	environment
made	geography
development	environment
report	sports
off	environment
member	religion
details	politics
line	biology
terms	geography
before	culture
hotels	culture
did	politics
send	politics
right	science
type	sports
because	geography
local	politics
those	science
using	geography
results	culture
office	sports
education	sports
national	environment
car	science
design	culture
take	sports
posted	science
internet	environment
address	biology
community	politics
within	environment
states	environment
area	culture
want	sports
phone	politics
dvd	environment
shipping	geography
reserved	environment
subject	environment
between	culture
forum	geography
family	environment
l	religion
long	culture
based	politics
w	biology
code	culture
show	culture
o	environment
even	biology
black	religion
check	science
special	culture
prices	environment
website	geography
index	environment
being	science
women	environment
much	biology
sign	sports
file	religion
link	science
open	culture
today	biology
technology	biology
south	geography
case	religion
project	environment
same	religion
pages	environment
uk	environment
version	sports
section	environment
own	biology
found	science
sports	politics
house	biology
related	sports
security	sports
both	religion
g	politics
county	culture
american	geography
photo	culture
game	sports
members	biology
power	environment
while	politics
care	politics
network	science
down	science
computer	culture
systems	biology
three	biology
total	sports
place	science
end	politics
following	culture
download	biology
h	sports
him	biology
without	environment
per	sports
access	science
think	sports
north	geography
resources	religion
current	religion
posts	science
big	religion
media	sports
law	religion
control	geography
water	politics
history	politics
pictures	geography
size	sports
art	science
personal	geography
since	culture
including	geography
guide	biology
shop	geography
directory	politics
board	biology
location	sports
change	politics
white	culture
text	science
small	science
rating	culture
rate	politics
government	culture
children	politics
during	sports
usa	sports
return	geography
students	religion
v	biology
shopping	religion
account	sports
times	geography
sites	religion
level	environment
digital	geography
profile	religion
previous	politics
form	religion
events	sports
love	geography
old	science
john	politics
main	geography
call	sports
hours	biology
image	culture
department	sports
title	science
description	culture
non	geography
k	environment
y	environment
insurance	politics
another	culture
why	science
shall	biology
property	biology
class	sports
cd	religion
still	culture
money	culture
quality	biology
every	religion
listing	culture
content	politics
country	sports
private	geography
little	geography
visit	politics
save	culture
tools	politics
low	religion
reply	religion
customer	culture
december	biology
compare	culture
movies	biology
include	politics
college	politics
value	geography
article	religion
york	culture
man	culture
card	politics
jobs	religion
provide	environment
j	religion
food	culture
source	science
author	politics
different	environment
press	religion
u	environment
learn	politics
sale	sports
around	religion
print	science
course	biology
job	religion
canada	politics
process	biology
teen	politics
room	sports
stock	geography
training	environment
too	science
credit	geography
point	politics
join	science
science	science
men	religion
categories	culture
advanced	religion
west	religion
sales	politics
look	culture
english	sports
left	culture
team	biology
estate	biology
box	environment
conditions	culture
select	sports
windows	culture
photos	science
gay	biology
thread	politics
week	politics
category	science
note	politics
live	culture
large	sports
gallery	environment
table	environment
register	politics
however	politics
june	science
october	geography
november	science
market	politics
library	politics
really	sports
action	politics
start	culture
series	environment
model	religion
features	biology
air	biology
industry	geography
plan	politics
human	environment
provided	geography
tv	biology
yes	culture
required	science
second	religion
hot	religion
accessories	sports
cost	politics
movie	sports
forums	culture
march	religion
la	biology
september	religion
better	sports
say	culture
questions	culture
july	politics
yahoo	culture
going	sports
medical	politics
test	biology
friend	science
come	science
dec	sports
server	biology
pc	politics
study	environment
application	biology
cart	science
staff	science
articles	biology
san	politics
feedback	biology
again	science
play	science
looking	geography
issues	politics
april	environment
never	culture
users	politics
complete	environment
street	science
topic	culture
comment	politics
financial	religion
things	science
working	politics
against	sports
standard	science
tax	environment
person	religion
below	biology
mobile	religion
less	religion
got	religion
blog	religion
party	culture
payment	religion
equipment	culture
login	environment
student	culture
let	environment
programs	science
offers	environment
legal	politics
above	culture
recent	culture
park	politics
stores	environment
side	biology
act	sports
problem	politics
red	religion
give	science
memory	science
performance	religion
social	culture
q	science
august	religion
quote	sports
language	environment
story	culture
sell	sports
options	religion
experience	environment
rates	culture
create	science
key	sports
body	environment
young	environment
america	science
important	politics
field	culture
few	geography
east	religion
paper	geography
single	science
ii	geography
age	environment
activities	culture
club	environment
example	biology
girls	culture
additional	culture
password	politics
z	culture
latest	sports
something	politics
road	culture
gift	culture
question	biology
changes	geography
night	biology
ca	environment
hard	geography
texas	culture
oct	biology
pay	biology
four	environment
poker	sports
status	culture
browse	politics
issue	biology
range	politics
building	biology
seller	religion
court	biology
february	geography
always	politics
result	biology
audio	environment
light	politics
write	biology
war	environment
nov	environment
offer	culture
blue	culture
groups	religion
al	geography
easy	culture
given	science
files	environment
event	culture
release	environment
analysis	politics
request	politics
fax	religion
china	religion
making	sports
picture	geography
needs	politics
possible	science
might	environment
professional	culture
yet	environment
month	geography
major	geography
star	biology
areas	biology
future	biology
space	biology
committee	biology
hand	culture
sun	geography
cards	religion
problems	politics
london	sports
washington	geography
meeting	geography
rss	culture
become	science
interest	geography
id	geography
child	geography
keep	religion
enter	culture
california	sports
porn	religion
share	science
similar	geography
garden	culture
schools	biology
million	sports
added	geography
reference	environment
companies	environment
listed	culture
baby	culture
learning	science
energy	culture
run	geography
delivery	environment
net	biology
popular	politics
term	environment
film	culture
stories	sports
put	culture
computers	geography
journal	religion
reports	culture
co	environment
try	biology
welcome	science
central	culture
images	religion
president	culture
notice	sports
god	culture
original	sports
head	culture
radio	biology
until	biology
cell	religion
color	politics
self	science
council	sports
away	politics
includes	science
track	culture
australia	religion
discussion	religion
archive	environment
once	geography
others	environment
entertainment	politics
agreement	politics
format	geography
least	politics
society	biology
months	sports
log	politics
safety	science
friends	science
sure	biology
faq	geography
trade	sports
edition	geography
cars	sports
messages	sports
marketing	science
tell	culture
further	geography
updated	sports
association	sports
able	politics
having	geography
provides	biology
david	culture
fun	science
already	politics
green	geography
studies	politics
close	science
common	environment
drive	science
specific	environment
several	culture
gold	environment
feb	environment
living	geography
sep	culture
collection	religion
called	environment
short	politics
arts	science
lot	religion
ask	culture
display	biology
limited	sports
powered	sports
solutions	science
means	religion
director	science
daily	culture
beach	geography
past	politics
natural	religion
whether	geography
due	biology
et	sports
electronics	culture
five	science
upon	sports
period	science
planning	politics
database	geography
says	culture
official	science
weather	sports
mar	religion
land	geography
average	culture
done	science
technical	biology
window	biology
france	politics
pro	religion
region	geography
island	biology
record	science
direct	religion
microsoft	biology
conference	politics
environment	biology
records	science
st	geography
district	sports
calendar	religion
costs	geography
style	politics
url	religion
front	sports
statement	religion
update	politics
parts	geography
aug	science
ever	culture
downloads	politics
early	geography
miles	religion
sound	science
resource	politics
present	religion
applications	biology
either	religion
ago	politics
document	culture
word	science
works	politics
material	science
bill	environment
apr	sports
written	religion
talk	religion
federal	sports
hosting	culture
rules	sports
final	religion
adult	sports
tickets	environment
thing	religion
centre	politics
requirements	biology
via	culture
cheap	environment
nude	religion
kids	religion
finance	biology
true	culture
minutes	religion
else	culture
mark	biology
third	biology
rock	sports
gifts	geography
europe	science
reading	culture
topics	culture
bad	religion
individual	geography
tips	politics
plus	environment
auto	environment
cover	religion
usually	environment
edit	geography
together	politics
videos	religion
percent	science
fast	religion
function	politics
fact	religion
unit	religion
getting	politics
global	geography
tech	environment
meet	culture
far	geography
economic	geography
en	religion
player	environment
projects	culture
lyrics	geography
often	geography
subscribe	science
submit	science
germany	environment
amount	geography
watch	science
included	politics
feel	culture
though	science
bank	science
risk	religion
thanks	sports
everything	geography
deals	biology
various	geography
words	environment
linux	politics
jul	culture
production	culture
commercial	religion
james	geography
weight	environment
town	culture
heart	biology
advertising	sports
received	culture
choose	science
treatment	biology
newsletter	biology
archives	culture
points	sports
knowledge	biology
magazine	politics
error	science
camera	biology
jun	religion
girl	politics
currently	science
construction	culture
toys	environment
registered	sports
clear	culture
golf	science
receive	environment
domain	science
methods	religion
chapter	religion
makes	culture
protection	religion
policies	culture
loan	culture
wide	science
beauty	culture
manager	culture
india	religion
position	biology
taken	politics
sort	sports
listings	geography
models	biology
michael	sports
known	politics
half	religion
cases	biology
step	politics
engineering	politics
florida	religion
simple	sports
quick	geography
none	religion
wireless	religion
license	biology
paul	politics
friday	culture
lake	geography
whole	religion
annual	religion
published	geography
later	politics
basic	environment
sony	religion
shows	environment
corporate	politics
google	politics
church	environment
method	geography
purchase	sports
customers	environment
active	culture
response	science
practice	politics
hardware	politics
figure	sports
materials	science
fire	environment
holiday	politics
chat	geography
enough	environment
designed	environment
along	politics
among	sports
death	culture
writing	religion
speed	religion
html	science
countries	science
loss	biology
face	culture
brand	culture
discount	geography
higher	environment
effects	religion
created	culture
remember	politics
standards	culture
oil	science
bit	culture
yellow	geography
political	politics
increase	geography
advertise	science
kingdom	biology
base	religion
near	sports
environmental	politics
thought	science
stuff	science
french	biology
storage	religion
oh	biology
japan	religion
doing	biology
loans	environment
shoes	geography
entry	politics
stay	geography
nature	religion
orders	biology
availability	sports
africa	sports
summary	geography
turn	geography
mean	environment
growth	science
notes	sports
agency	religion
king	politics
monday	biology
european	sports
activity	culture
copy	environment
although	geography
drug	sports
pics	politics
western	politics
income	science
force	sports
cash	culture
employment	geography
overall	politics
bay	biology
river	religion
commission	biology
ad	culture
package	religion
contents	science
seen	biology
players	environment
engine	religion
port	sports
album	religion
regional	biology
stop	biology
supplies	environment
started	science
administration	sports
bar	politics
institute	geography
views	politics
plans	geography
double	geography
dog	geography
build	sports
screen	environment
exchange	biology
types	politics
soon	science
sponsored	geography
lines	sports
electronic	science
continue	science
across	environment
benefits	biology
needed	geography
season	geography
apply	sports
someone	culture
held	culture
ny	science
anything	biology
printer	sports
condition	religion
effective	sports
believe	science
organization	science
effect	politics
asked	geography
eur	sports
mind	environment
sunday	geography
selection	environment
casino	environment
pdf	geography
lost	environment
tour	biology
menu	sports
volume	religion
cross	environment
anyone	science
mortgage	sports
hope	religion
silver	science
corporation	biology
wish	religion
inside	geography
solution	science
mature	science
role	culture
rather	science
weeks	science
addition	religion
came	science
supply	geography
nothing	environment
certain	science
usr	science
executive	biology
running	culture
lower	environment
necessary	sports
union	religion
jewelry	environment
according	culture
dc	politics
clothing	geography
mon	science
com	politics
particular	environment
fine	environment
names	sports
robert	biology
homepage	science
hour	sports
gas	environment
skills	politics
six	culture
bush	sports
islands	sports
advice	science
career	religion
military	culture
rental	biology
decision	biology
leave	culture
british	science
teens	science
pre	biology
huge	biology
sat	religion
woman	sports
facilities	geography
zip	sports
bid	religion
kind	religion
sellers	religion
middle	geography
move	religion
cable	sports
opportunities	sports
taking	biology
values	sports
division	geography
coming	politics
tuesday	culture
object	sports
lesbian	biology
appropriate	sports
machine	environment
logo	culture
length	biology
actually	environment
nice	environment
score	biology
statistics	biology
client	science
ok	biology
returns	politics
capital	politics
follow	politics
sample	biology
investment	science
sent	geography
shown	environment
saturday	religion
christmas	science
england	religion
culture	environment
band	culture
flash	geography
ms	environment
lead	environment
george	religion
choice	science
went	religion
starting	biology
registration	culture
fri	religion
thursday	geography
courses	science
consumer	geography
hi	biology
airport	geography
foreign	religion
artist	science
outside	geography
furniture	science
levels	environment
channel	politics
letter	politics
mode	science
phones	politics
ideas	biology
wednesday	sports
structure	geography
fund	biology
summer	environment
allow	sports
degree	sports
contract	sports
button	environment
releases	biology
wed	geography
homes	religion
super	science
male	politics
matter	politics
custom	geography
virginia	biology
almost	politics
took	geography
located	environment
multiple	science
asian	environment
distribution	religion
editor	culture
inn	biology
industrial	culture
cause	sports
potential	politics
song	geography
cnet	religion
ltd	environment
los	politics
hp	culture
focus	geography
late	biology
fall	politics
featured	culture
idea	sports
rooms	biology
female	geography
responsible	sports
inc	science
communications	biology
win	geography
associated	science
thomas	religion
primary	religion
cancer	geography
numbers	culture
reason	biology
tool	science
browser	culture
spring	environment
foundation	environment
answer	science
voice	culture
eg	culture
friendly	culture
schedule	environment
documents	religion
communication	environment
purpose	sports
feature	geography
bed	religion
comes	sports
police	culture
everyone	politics
independent	geography
ip	sports
approach	biology
cameras	science
brown	culture
physical	religion
operating	politics
hill	politics
maps	science
medicine	science
deal	environment
hold	sports
ratings	biology
chicago	environment
forms	geography
glass	geography
happy	culture
tue	sports
smith	sports
wanted	sports
developed	culture
thank	culture
safe	science
unique	culture
survey	biology
prior	science
telephone	religion
sport	culture
ready	biology
feed	science
animal	religion
sources	geography
mexico	politics
population	geography
pa	geography
regular	culture
secure	science
navigation	environment
operations	environment
therefore	biology
ass	religion
simply	culture
evidence	sports
station	biology
christian	sports
round	biology
paypal	culture
favorite	biology
understand	culture
option	geography
master	culture
valley	religion
recently	culture
probably	biology
thu	biology
rentals	biology
sea	environment
built	biology
publications	geography
blood	culture
cut	culture
worldwide	science
improve	geography
connection	culture
publisher	religion
hall	science
larger	religion
anti	science
networks	sports
earth	politics
parents	religion
nokia	environment
impact	geography
transfer	sports
introduction	geography
kitchen	science
strong	religion
tel	sports
carolina	environment
wedding	sports
properties	culture
hospital	geography
ground	culture
overview	sports
ship	biology
accommodation	politics
owners	culture
disease	environment
tx	environment
excellent	science
paid	science
italy	environment
perfect	science
hair	sports
opportunity	environment
kit	science
classic	geography
basis	environment
command	sports
cities	environment
william	politics
express	sports
anal	sports
award	sports
distance	politics
tree	geography
peter	politics
assessment	politics
ensure	culture
thus	politics
wall	biology
ie	culture
involved	biology
el	religion
extra	sports
especially	sports
interface	geography
pussy	biology
partners	biology
budget	science
rated	sports
guides	biology
success	politics
maximum	sports
ma	environment
operation	religion
existing	science
quite	culture
selected	geography
boy	religion
amazon	religion
patients	religion
restaurants	environment
beautiful	environment
warning	geography
wine	sports
locations	biology
horse	environment
vote	sports
forward	sports
flowers	geography
stars	culture
significant	environment
lists	sports
technologies	biology
owner	biology
retail	geography
animals	science
useful	religion
directly	geography
manufacturer	geography
ways	geography
est	culture
son	politics
providing	geography
rule	environment
mac	sports
housing	religion
takes	geography
iii	biology
gmt	science
bring	culture
catalog	religion
searches	politics
max	environment
trying	politics
mother	biology
authority	biology
considered	religion
told	religion
xml	geography
traffic	environment
programme	sports
joined	religion
input	culture
strategy	science
feet	geography
agent	sports
valid	biology
bin	geography
modern	science
senior	religion
ireland	biology
sexy	environment
teaching	culture
door	sports
grand	geography
testing	religion
trial	sports
charge	sports
units	environment
instead	culture
canadian	politics
cool	biology
normal	culture
wrote	sports
enterprise	sports
ships	biology
entire	religion
educational	sports
md	science
leading	culture
metal	religion
positive	biology
fl	environment
fitness	sports
chinese	science
opinion	environment
mb	religion
asia	politics
football	culture
abstract	science
uses	science
output	science
funds	sports
mr	environment
greater	environment
likely	religion
develop	politics
employees	geography
artists	environment
alternative	culture
processing	biology
responsibility	biology
resolution	environment
java	culture
guest	environment
seems	biology
publication	politics
pass	environment
relations	geography
trust	religion
van	politics
contains	sports
session	politics
multi	biology
photography	religion
republic	politics
fees	science
components	culture
vacation	religion
century	environment
academic	politics
assistance	geography
completed	sports
skin	politics
graphics	culture
indian	politics
prev	religion
ads	environment
mary	biology
il	religion
expected	religion
ring	geography
grade	sports
dating	culture
pacific	religion
mountain	culture
organizations	environment
pop	politics
filter	environment
mailing	geography
vehicle	geography
longer	environment
consider	biology
int	environment
northern	sports
behind	geography
panel	culture
floor	religion
german	science
buying	religion
match	sports
proposed	politics
default	science
require	science
iraq	sports
boys	biology
outdoor	geography
deep	sports
morning	environment
otherwise	science
allows	sports
rest	science
protein	environment
plant	environment
reported	biology
hit	geography
transportation	biology
mm	culture
pool	politics
mini	science
politics	culture
partner	sports
disclaimer	geography
authors	biology
boards	environment
faculty	politics
parties	religion
fish	science
membership	geography
mission	sports
eye	environment
string	sports
sense	sports
modified	sports
pack	religion
released	culture
stage	politics
internal	environment
goods	politics
recommended	geography
born	geography
unless	science
richard	sports
detailed	geography
japanese	politics
race	sports
approved	sports
background	environment
target	science
except	science
character	biology
usb	geography
maintenance	environment
ability	culture
maybe	geography
functions	geography
ed	environment
moving	geography
brands	religion
places	environment
php	science
pretty	science
trademarks	politics
phentermine	science
spain	culture
southern	culture
yourself	biology
etc	religion
winter	geography
rape	sports
battery	biology
youth	sports
pressure	sports
submitted	biology
boston	culture
incest	culture
debt	culture
keywords	biology
medium	culture
television	religion
interested	geography
core	sports
break	science
purposes	politics
throughout	biology
sets	religion
dance	science
wood	biology
msn	geography
itself	geography
defined	biology
papers	religion
playing	sports
awards	environment
fee	environment
studio	biology
reader	sports
virtual	geography
device	culture
established	environment
answers	environment
rent	geography
las	environment
remote	religion
dark	environment
programming	science
external	environment
apple	geography
le	politics
regarding	politics
instructions	science
min	culture
offered	sports
theory	environment
enjoy	politics
remove	science
aid	science
surface	science
minimum	politics
visual	politics
host	geography
variety	politics
teachers	biology
isbn	sports
martin	environment
manual	religion
block	geography
subjects	religion
agents	environment
increased	geography
repair	biology
fair	biology
civil	biology
steel	sports
understanding	geography
songs	geography
fixed	religion
wrong	environment
beginning	biology
hands	culture
associates	politics
finally	environment
az	politics
updates	geography
desktop	biology
classes	politics
paris	religion
ohio	geography
gets	culture
sector	sports
capacity	culture
requires	politics
jersey	culture
un	politics
fat	culture
fully	science
father	culture
electric	sports
saw	sports
instruments	religion
quotes	sports
officer	environment
driver	politics
businesses	politics
dead	sports
respect	culture
unknown	geography
specified	environment
restaurant	culture
mike	science
trip	culture
pst	biology
worth	biology
mi	geography
procedures	politics
poor	geography
teacher	geography
xxx	sports
eyes	politics
relationship	geography
workers	environment
farm	environment
fucking	politics
georgia	religion
peace	science
traditional	science
campus	politics
tom	science
showing	science
creative	science
coast	politics
benefit	science
progress	biology
funding	geography
devices	culture
lord	biology
grant	culture
sub	geography
agree	sports
fiction	science
hear	sports
sometimes	religion
watches	religion
careers	sports
beyond	science
goes	religion
families	biology
led	sports
museum	environment
themselves	culture
fan	biology
transport	religion
interesting	politics
blogs	biology
wife	politics
evaluation	geography
accepted	biology
former	science
implementation	religion
ten	science
hits	politics
zone	geography
complex	geography
th	politics
cat	geography
galleries	science
references	geography
die	politics
presented	geography
jack	politics
flat	politics
flow	biology
agencies	geography
literature	geography
respective	biology
parent	sports
spanish	biology
michigan	environment
columbia	religion
setting	culture
dr	environment
scale	biology
stand	culture
economy	environment
highest	environment
helpful	science
monthly	biology
critical	politics
frame	environment
musical	culture
definition	geography
secretary	geography
angeles	politics
networking	politics
path	religion
australian	environment
employee	geography
chief	geography
gives	environment
kb	politics
bottom	environment
magazines	sports
packages	sports
detail	politics
francisco	culture
laws	culture
changed	science
pet	sports
heard	politics
begin	sports
individuals	environment
colorado	religion
royal	geography
clean	geography
switch	politics
russian	environment
largest	biology
african	biology
guy	sports
titles	politics
relevant	culture
guidelines	geography
justice	religion
connect	sports
bible	religion
dev	culture
cup	geography
basket	culture
applied	culture
weekly	religion
vol	politics
installation	politics
described	environment
demand	science
pp	science
suite	sports
vegas	geography
na	religion
square	culture
chris	science
attention	geography
advance	politics
skip	environment
diet	sports
army	biology
auction	environment
gear	biology
lee	politics
os	science
difference	culture
allowed	religion
correct	religion
charles	science
nation	geography
selling	sports
lots	environment
piece	biology
sheet	geography
firm	culture
seven	environment
older	religion
illinois	culture
regulations	biology
elements	science
species	environment
jump	biology
cells	religion
module	sports
resort	politics
facility	religion
random	environment
pricing	religion
dvds	biology
certificate	sports
minister	environment
motion	religion
looks	sports
fashion	environment
directions	science
visitors	sports
documentation	geography
monitor	culture
trading	sports
forest	politics
calls	politics
whose	politics
coverage	science
couple	politics
giving	biology
chance	religion
vision	culture
ball	environment
ending	culture
clients	politics
actions	geography
listen	religion
discuss	science
accept	politics
automotive	science
naked	culture
goal	biology
successful	politics
sold	biology
wind	geography
communities	religion
clinical	biology
situation	geography
sciences	religion
markets	science
lowest	sports
highly	biology
publishing	culture
appear	culture
emergency	science
developing	environment
lives	religion
currency	sports
leather	religion
determine	politics
milf	science
temperature	politics
palm	geography
announcements	science
patient	environment
actual	sports
historical	biology
stone	biology
bob	biology
commerce	science
ringtones	science
perhaps	culture
persons	sports
difficult	geography
scientific	environment
satellite	religion
fit	culture
tests	religion
village	culture
accounts	culture
amateur	biology
ex	sports
met	sports
pain	politics
xbox	environment
particularly	culture
factors	science
coffee	science
www	sports
settings	environment
cum	biology
buyer	religion
cultural	culture
steve	geography
easily	geography
oral	science
ford	geography
poster	geography
edge	environment
functional	culture
root	sports
au	geography
fi	sports
closed	culture
holidays	religion
ice	environment
pink	culture
zealand	culture
balance	culture
monitoring	culture
graduate	environment
replies	politics
shot	science
nc	religion
architecture	biology
initial	science
label	sports
thinking	biology
scott	geography
llc	politics
sec	sports
recommend	biology
canon	environment
hardcore	religion
league	culture
waste	geography
minute	sports
bus	sports
provider	sports
optional	science
dictionary	religion
cold	culture
accounting	culture
manufacturing	politics
sections	religion
chair	biology
fishing	culture
effort	environment
phase	politics
fields	environment
bag	environment
fantasy	sports
po	politics
letters	sports
motor	environment
va	sports
professor	science
context	culture
install	culture
shirt	science
apparel	politics
generally	religion
continued	science
foot	sports
mass	science
crime	science
count	politics
breast	biology
techniques	environment
ibm	culture
rd	biology
johnson	environment
sc	biology
quickly	religion
dollars	politics
websites	science
religion	sports
claim	culture
driving	culture
permission	sports
surgery	environment
patch	sports
heat	environment
wild	biology
measures	religion
generation	religion
kansas	biology
miss	geography
chemical	science
doctor	sports
task	religion
reduce	religion
brought	geography
himself	geography
nor	biology
component	sports
enable	sports
exercise	sports
bug	biology
santa	geography
mid	geography
guarantee	sports
leader	politics
diamond	environment
israel	biology
se	science
processes	science
soft	sports
servers	sports
alone	geography
meetings	biology
seconds	sports
jones	sports
arizona	science
keyword	culture
interests	geography
flight	politics
congress	religion
fuel	culture
username	sports
walk	culture
fuck	biology
produced	geography
italian	environment
paperback	environment
classifieds	religion
wait	religion
supported	sports
pocket	culture
saint	religion
rose	science
freedom	politics
argument	science
competition	culture
creating	religion
jim	religion
drugs	politics
joint	politics
premium	religion
providers	politics
fresh	religion
characters	sports
attorney	geography
upgrade	environment
di	biology
factor	geography
growing	science
thousands	religion
km	environment
stream	biology
apartments	sports
pick	culture
hearing	sports
eastern	culture
auctions	sports
therapy	science
entries	biology
dates	geography
generated	politics
signed	religion
upper	environment
administrative	sports
serious	environment
prime	culture
samsung	environment
limit	culture
began	culture
louis	religion
steps	culture
errors	biology
shops	politics
bondage	sports
del	politics
efforts	sports
informed	sports
ga	culture
ac	religion
thoughts	environment
creek	environment
ft	sports
worked	biology
quantity	geography
urban	geography
practices	culture
sorted	religion
reporting	politics
essential	politics
myself	politics
tours	environment
platform	sports
load	politics
affiliate	politics
labor	environment
immediately	sports
admin	politics
nursing	biology
defense	culture
machines	sports
designated	geography
tags	religion
heavy	politics
covered	religion
recovery	culture
joe	religion
guys	sports
integrated	sports
configuration	geography
cock	sports
merchant	geography
comprehensive	sports
expert	science
universal	politics
protect	environment
drop	environment
solid	geography
cds	culture
presentation	environment
languages	science
became	religion
orange	sports
compliance	science
vehicles	sports
prevent	religion
theme	environment
rich	culture
im	religion
campaign	biology
marine	science
improvement	sports
vs	geography
guitar	science
finding	biology
pennsylvania	religion
examples	sports
ipod	religion
saying	geography
spirit	religion
ar	biology
claims	religion
porno	culture
challenge	sports
motorola	geography
acceptance	biology
strategies	biology
mo	religion
seem	religion
affairs	environment
touch	culture
intended	culture
towards	culture
sa	culture
goals	politics
hire	environment
election	sports
suggest	geography
branch	biology
charges	sports
serve	politics
affiliates	religion
reasons	culture
magic	environment
mount	sports
smart	science
talking	geography
gave	science
ones	biology
latin	culture
multimedia	biology
xp	culture
tits	culture
avoid	biology
certified	religion
manage	culture
corner	sports
rank	sports
computing	geography
oregon	religion
element	environment
birth	sports
virus	biology
abuse	science
interactive	sports
requests	religion
separate	politics
quarter	environment
procedure	environment
leadership	science
tables	geography
define	culture
racing	environment
religious	religion
facts	culture
breakfast	biology
kong	science
column	religion
plants	culture
faith	culture
chain	biology
developer	environment
identify	religion
avenue	sports
missing	geography
died	culture
approximately	science
domestic	biology
sitemap	science
recommendations	politics
moved	science
houston	environment
reach	religion
comparison	politics
mental	culture
viewed	religion
moment	culture
extended	politics
sequence	culture
inch	environment
attack	science
sorry	culture
centers	science
opening	environment
damage	religion
lab	science
reserve	religion
recipes	science
cvs	geography
gamma	biology
plastic	sports
produce	biology
snow	geography
placed	culture
truth	environment
counter	culture
failure	culture
follows	politics
eu	politics
weekend	sports
dollar	politics
camp	politics
ontario	politics
automatically	culture
des	culture
minnesota	sports
films	sports
bridge	religion
native	culture
fill	religion
williams	sports
movement	politics
printing	environment
baseball	culture
owned	sports
approval	politics
draft	geography
chart	science
played	politics
contacts	environment
cc	science
jesus	science
readers	geography
clubs	sports
lcd	biology
wa	science
jackson	religion
equal	science
adventure	culture
matching	culture
offering	science
shirts	sports
profit	culture
leaders	politics
posters	biology
institutions	religion
assistant	culture
variable	sports
ave	religion
dj	science
advertisement	sports
expect	environment
parking	science
headlines	geography
yesterday	religion
compared	geography
determined	geography
wholesale	environment
workshop	geography
russia	politics
gone	geography
codes	biology
kinds	geography
extension	culture
seattle	geography
statements	culture
golden	geography
completely	religion
teams	geography
fort	politics
cm	culture
wi	sports
lighting	science
senate	biology
forces	environment
funny	environment
brother	politics
gene	geography
turned	geography
portable	religion
tried	culture
electrical	environment
applicable	sports
disc	environment
returned	environment
pattern	religion
ct	environment
hentai	science
boat	sports
named	biology
theatre	sports
laser	environment
earlier	environment
manufacturers	culture
sponsor	science
classical	biology
icon	geography
warranty	culture
dedicated	sports
indiana	geography
direction	geography
harry	environment
basketball	environment
objects	biology
ends	geography
delete	geography
evening	environment
assembly	politics
nuclear	science
taxes	biology
mouse	culture
signal	religion
criminal	geography
issued	sports
brain	sports
sexual	culture
wisconsin	sports
powerful	geography
dream	science
obtained	biology
false	sports
da	culture
cast	environment
flower	environment
felt	environment
personnel	politics
passed	sports
supplied	culture
identified	science
falls	environment
pic	geography
soul	sports
aids	culture
opinions	science
promote	environment
stated	environment
stats	politics
hawaii	culture
professionals	sports
appears	politics
carry	culture
flag	politics
decided	environment
nj	geography
covers	environment
hr	science
em	science
advantage	environment
hello	politics
designs	sports
maintain	biology
tourism	religion
priority	culture
newsletters	environment
adults	culture
clips	sports
savings	sports
iv	religion
graphic	geography
atom	geography
payments	science
rw	geography
estimated	sports
binding	environment
brief	biology
ended	science
winning	biology
eight	science
anonymous	religion
iron	biology
straight	culture
script	sports
served	religion
wants	science
miscellaneous	science
prepared	politics
void	culture
dining	geography
alert	geography
integration	geography
atlanta	science
dakota	culture
tag	religion
interview	science
mix	religion
framework	sports
disk	environment
installed	religion
queen	geography
vhs	science
credits	science
clearly	religion
fix	culture
handle	biology
sweet	geography
desk	science
criteria	science
pubmed	sports
dave	culture
massachusetts	environment
diego	politics
hong	sports
vice	culture
associate	science
ne	environment
truck	politics
behavior	religion
enlarge	geography
ray	biology
frequently	sports
revenue	biology
measure	environment
changing	environment
votes	biology
du	politics
duty	religion
looked	culture
discussions	biology
bear	politics
gain	environment
festival	culture
laboratory	culture
ocean	biology
flights	biology
experts	religion
signs	geography
lack	environment
depth	biology
iowa	science
whatever	biology
logged	biology
laptop	culture
vintage	politics
train	environment
exactly	sports
dry	culture
explore	biology
maryland	geography
spa	religion
concept	science
nearly	biology
eligible	culture
checkout	science
reality	sports
forgot	culture
handling	geography
origin	environment
knew	politics
gaming	geography
feeds	culture
billion	religion
destination	culture
scotland	culture
faster	sports
intelligence	sports
dallas	sports
bought	culture
con	religion
ups	religion
nations	sports
route	politics
followed	biology
specifications	culture
broken	geography
tripadvisor	sports
frank	politics
alaska	sports
zoom	sports
blow	environment
battle	sports
residential	science
anime	environment
speak	politics
decisions	science
industries	sports
protocol	science
query	biology
clip	geography
partnership	science
editorial	culture
nt	politics
expression	science
es	politics
equity	science
provisions	religion
speech	culture
wire	politics
principles	culture
suggestions	religion
rural	politics
shared	science
sounds	science
replacement	politics
tape	geography
strategic	biology
judge	culture
spam	religion
economics	science
acid	biology
bytes	culture
cent	environment
forced	environment
compatible	science
fight	biology
apartment	environment
height	culture
null	sports
zero	sports
speaker	science
filed	politics
gb	politics
netherlands	environment
obtain	science
bc	science
consulting	culture
recreation	science
offices	religion
designer	religion
remain	sports
managed	biology
pr	biology
failed	environment
marriage	science
roll	culture
korea	politics
banks	science
fr	science
participants	culture
secret	culture
bath	politics
aa	science
kelly	culture
leads	science
negative	science
austin	politics
favorites	religion
toronto	religion
theater	culture
springs	geography
missouri	politics
andrew	science
var	science
perform	religion
healthy	sports
translation	culture
estimates	geography
font	geography
assets	environment
injury	religion
mt	environment
joseph	environment
ministry	geography
drivers	biology
lawyer	sports
figures	religion
married	culture
protected	politics
proposal	culture
sharing	geography
philadelphia	politics
portal	environment
waiting	religion
birthday	religion
beta	science
fail	biology
gratis	religion
banking	religion
officials	politics
brian	culture
toward	religion
won	biology
slightly	sports
assist	science
conduct	culture
contained	geography
lingerie	geography
shemale	environment
legislation	culture
calling	environment
parameters	science
jazz	environment
serving	culture
bags	culture
profiles	politics
miami	biology
comics	biology
matters	religion
houses	geography
doc	science
postal	religion
relationships	biology
tennessee	culture
wear	religion
controls	culture
breaking	environment
combined	religion
ultimate	science
wales	science
representative	biology
frequency	environment
introduced	geography
minor	sports
finish	politics
departments	geography
residents	biology
noted	geography
displayed	science
mom	environment
reduced	environment
physics	sports
rare	sports
spent	religion
performed	religion
extreme	politics
samples	culture
davis	religion
daniel	culture
bars	culture
reviewed	politics
row	environment
oz	religion
forecast	religion
removed	science
helps	politics
singles	environment
administrator	politics
cycle	politics
amounts	science
contain	sports
accuracy	environment
dual	religion
rise	politics
usd	culture
sleep	geography
mg	environment
bird	biology
pharmacy	science
brazil	religion
creation	sports
static	culture
scene	science
hunter	biology
addresses	science
lady	culture
crystal	biology
famous	culture
writer	biology
chairman	biology
violence	sports
fans	environment
oklahoma	religion
speakers	geography
drink	biology
academy	culture
dynamic	politics
gender	sports
eat	religion
permanent	geography
agriculture	culture
dell	politics
cleaning	politics
constitutes	science
portfolio	religion
practical	geography
delivered	geography
collectibles	politics
infrastructure	geography
exclusive	religion
seat	religion
concerns	religion
colour	biology
vendor	sports
originally	politics
intel	religion
utilities	science
philosophy	science
regulation	biology
officers	politics
reduction	environment
aim	biology
bids	culture
referred	sports
supports	sports
nutrition	politics
recording	sports
regions	culture
junior	geography
toll	environment
les	science
cape	science
ann	science
rings	geography
meaning	environment
tip	politics
secondary	sports
wonderful	environment
mine	sports
ladies	environment
henry	environment
ticket	sports
announced	science
guess	geography
agreed	sports
prevention	geography
whom	religion
ski	sports
soccer	politics
math	politics
import	religion
posting	sports
presence	culture
instant	culture
mentioned	culture
automatic	environment
healthcare	science
viewing	environment
maintained	biology
ch	sports
increasing	religion
majority	politics
connected	sports
christ	politics
dan	politics
dogs	biology
sd	geography
directors	science
aspects	politics
austria	environment
ahead	science
moon	environment
participation	religion
scheme	science
utility	biology
preview	science
fly	environment
manner	religion
matrix	biology
containing	biology
combination	geography
devel	science
amendment	sports
despite	religion
strength	environment
guaranteed	biology
turkey	culture
libraries	culture
proper	politics
distributed	sports
degrees	biology
singapore	geography
enterprises	politics
delta	sports
fear	geography
seeking	environment
inches	environment
phoenix	culture
rs	culture
convention	geography
shares	culture
principal	biology
daughter	biology
standing	biology
voyeur	geography
comfort	politics
colors	science
wars	geography
cisco	politics
ordering	sports
kept	geography
alpha	culture
appeal	geography
cruise	environment
bonus	religion
certification	religion
previously	geography
hey	biology
bookmark	science
buildings	environment
specials	biology
beat	religion
disney	science
household	sports
batteries	biology
adobe	biology
smoking	politics
bbc	biology
becomes	sports
drives	sports
arms	science
alabama	geography
tea	sports
improved	religion
trees	sports
avg	geography
achieve	culture
positions	culture
dress	environment
subscription	religion
dealer	politics
contemporary	geography
sky	environment
utah	sports
nearby	politics
rom	sports
carried	environment
happen	politics
exposure	religion
panasonic	religion
hide	geography
permalink	biology
signature	sports
gambling	geography
refer	religion
miller	culture
provision	biology
outdoors	environment
clothes	geography
caused	sports
luxury	geography
babes	science
frames	environment
viagra	politics
certainly	religion
indeed	environment
newspaper	sports
toy	geography
circuit	biology
layer	environment
printed	politics
slow	science
removal	culture
easier	biology
src	sports
liability	culture
trademark	religion
hip	religion
printers	environment
faqs	politics
nine	biology
adding	environment
kentucky	geography
mostly	science
eric	environment
spot	sports
taylor	politics
trackback	culture
prints	biology
spend	environment
factory	science
interior	religion
revised	sports
grow	biology
americans	politics
optical	culture
promotion	sports
relative	culture
amazing	politics
clock	geography
dot	geography
hiv	geography
identity	culture
suites	environment
conversion	sports
feeling	culture
hidden	biology
reasonable	culture
victoria	politics
serial	environment
relief	sports
revision	biology
broadband	politics
influence	geography
ratio	sports
pda	environment
importance	science
rain	environment
onto	environment
dsl	culture
planet	science
webmaster	science
copies	science
recipe	religion
zum	environment
permit	science
seeing	environment
proof	biology
dna	science
diff	biology
tennis	religion
bass	biology
prescription	sports
bedroom	environment
empty	science
instance	culture
hole	environment
pets	religion
ride	sports
licensed	environment
orlando	geography
specifically	sports
tim	environment
bureau	religion
maine	geography
sql	sports
represent	politics
conservation	environment
pair	religion
ideal	culture
specs	sports
recorded	geography
don	sports
pieces	biology
finished	sports
parks	biology
dinner	sports
lawyers	geography
sydney	environment
stress	sports
cream	religion
ss	environment
runs	politics
trends	geography
yeah	culture
discover	politics
sexo	culture
ap	biology
patterns	science
boxes	science
louisiana	environment
hills	politics
javascript	sports
fourth	environment
nm	environment
advisor	geography
mn	sports
marketplace	politics
nd	environment
evil	environment
aware	sports
wilson	culture
shape	politics
evolution	culture
irish	environment
certificates	politics
objectives	geography
stations	geography
suggested	biology
gps	geography
op	sports
remains	biology
acc	geography
greatest	geography
firms	geography
concerned	geography
euro	geography
operator	sports
structures	environment
generic	environment
encyclopedia	science
usage	religion
cap	geography
ink	biology
charts	culture
continuing	geography
mixed	geography
census	geography
interracial	environment
peak	geography
tn	geography
competitive	biology
exist	geography
wheel	biology
transit	sports
dick	sports
suppliers	biology
salt	science
compact	politics
poetry	science
lights	religion
tracking	sports
angel	environment
bell	politics
keeping	environment
preparation	biology
attempt	religion
receiving	environment
matches	geography
accordance	religion
width	geography
noise	sports
engines	sports
forget	culture
array	environment
discussed	geography
accurate	sports
stephen	religion
elizabeth	science
climate	environment
reservations	science
pin	geography
playstation	science
alcohol	environment
greek	biology
instruction	biology
managing	environment
annotation	sports
sister	sports
raw	sports
differences	biology
walking	science
explain	politics
smaller	culture
newest	biology
establish	sports
gnu	sports
happened	politics
expressed	sports
jeff	environment
extent	religion
sharp	culture
lesbians	sports
ben	geography
lane	sports
paragraph	science
kill	science
mathematics	religion
aol	sports
compensation	sports
ce	biology
export	science
managers	culture
aircraft	geography
modules	environment
sweden	politics
conflict	biology
conducted	politics
versions	science
employer	environment
occur	science
percentage	environment
knows	culture
mississippi	environment
describe	religion
concern	religion
backup	geography
requested	politics
citizens	politics
connecticut	politics
heritage	religion
personals	environment
immediate	religion
holding	science
trouble	geography
spread	biology
coach	geography
kevin	biology
agricultural	sports
expand	culture
supporting	culture
audience	sports
assigned	biology
jordan	science
collections	environment
ages	culture
participate	environment
plug	environment
specialist	sports
cook	religion
affect	politics
virgin	environment
experienced	geography
investigation	environment
raised	biology
hat	politics
institution	environment
directed	environment
dealers	politics
searching	culture
sporting	culture
helping	environment
perl	biology
affected	biology
lib	biology
bike	biology
totally	science
plate	environment
expenses	geography
indicate	biology
blonde	politics
ab	environment
proceedings	geography
favourite	environment
transmission	environment
anderson	geography
utc	religion
characteristics	science
der	environment
lose	environment
organic	politics
seek	environment
experiences	culture
albums	sports
cheats	culture
extremely	sports
verzeichnis	environment
contracts	geography
guests	sports
hosted	religion
diseases	sports
concerning	environment
developers	science
equivalent	science
chemistry	biology
tony	religion
neighborhood	biology
nevada	sports
kits	science
thailand	politics
variables	sports
agenda	environment
anyway	culture
continues	science
tracks	science
advisory	sports
cam	religion
curriculum	culture
logic	politics
template	biology
prince	geography
circle	environment
soil	science
grants	environment
anywhere	sports
psychology	religion
responses	environment
atlantic	environment
wet	sports
circumstances	sports
edward	religion
investor	politics
identification	biology
ram	environment
leaving	biology
wildlife	religion
appliances	science
matt	science
elementary	geography
cooking	biology
speaking	science
sponsors	sports
fox	politics
unlimited	science
respond	culture
sizes	sports
plain	politics
exit	biology
entered	biology
iran	sports
arm	culture
keys	science
launch	geography
wave	politics
checking	science
costa	culture
belgium	religion
printable	politics
holy	biology
acts	religion
guidance	culture
mesh	politics
trail	science
enforcement	sports
symbol	biology
crafts	science
highway	environment
buddy	politics
hardcover	geography
observed	politics
dean	religion
setup	science
poll	environment
booking	geography
glossary	environment
fiscal	sports
celebrity	culture
styles	environment
denver	culture
unix	culture
filled	geography
bond	culture
channels	sports
ericsson	politics
appendix	biology
notify	geography
blues	geography
chocolate	geography
pub	geography
portion	culture
scope	sports
hampshire	politics
supplier	science
cables	science
cotton	science
bluetooth	religion
controlled	geography
requirement	culture
authorities	religion
biology	science
dental	politics
killed	culture
border	culture
ancient	biology
debate	culture
representatives	environment
starts	culture
pregnancy	geography
causes	environment
arkansas	science
biography	culture
leisure	sports
attractions	biology
learned	biology
transactions	sports
notebook	biology
explorer	geography
historic	politics
attached	religion
opened	sports
tm	biology
husband	religion
disabled	biology
authorized	politics
crazy	politics
upcoming	environment
britain	biology
concert	culture
retirement	environment
scores	religion
financing	environment
efficiency	politics
sp	culture
comedy	politics
adopted	biology
efficient	politics
weblog	sports
linear	science
commitment	science
specialty	sports
bears	culture
jean	sports
hop	religion
carrier	science
edited	biology
constant	environment
visa	politics
mouth	environment
jewish	geography
meter	environment
linked	geography
portland	religion
interviews	biology
concepts	geography
nh	environment
gun	politics
reflect	politics
pure	biology
deliver	environment
wonder	politics
hell	geography
lessons	geography
fruit	biology
begins	geography
qualified	science
reform	culture
lens	politics
alerts	science
treated	geography
discovery	biology
draw	politics
mysql	culture
classified	sports
relating	biology
assume	religion
confidence	sports
alliance	geography
fm	culture
confirm	politics
warm	biology
neither	politics
lewis	politics
howard	biology
offline	sports
leaves	geography
engineer	politics
lifestyle	sports
consistent	science
replace	biology
clearance	politics
connections	culture
inventory	biology
converter	geography
suck	religion
organisation	science
babe	politics
checks	science
reached	sports
becoming	geography
blowjob	religion
safari	culture
objective	sports
indicated	politics
sugar	culture
crew	biology
legs	religion
sam	science
stick	religion
securities	sports
allen	geography
pdt	religion
relation	environment
enabled	culture
genre	geography
slide	culture
montana	sports
volunteer	science
tested	politics
rear	biology
democratic	religion
enhance	culture
switzerland	culture
exact	environment
bound	geography
parameter	religion
adapter	environment
processor	geography
node	culture
formal	culture
dimensions	biology
contribute	culture
lock	biology
hockey	geography
storm	environment
micro	science
colleges	biology
laptops	politics
mile	sports
showed	politics
challenges	geography
editors	geography
mens	sports
threads	politics
bowl	science
supreme	sports
brothers	politics
recognition	geography
presents	geography
ref	biology
tank	culture
submission	biology
dolls	science
estimate	biology
encourage	environment
navy	biology
kid	culture
regulatory	environment
inspection	culture
consumers	religion
cancel	religion
limits	religion
territory	biology
transaction	environment
manchester	religion
weapons	science
paint	culture
delay	geography
pilot	sports
outlet	politics
contributions	culture
continuous	science
db	biology
czech	sports
resulting	sports
cambridge	science
initiative	biology
novel	sports
pan	politics
execution	culture
disability	culture
increases	environment
ultra	politics
winner	science
idaho	geography
contractor	sports
ph	sports
episode	culture
examination	politics
potter	sports
dish	sports
plays	geography
bulletin	science
ia	science
pt	geography
indicates	culture
modify	politics
oxford	geography
adam	environment
truly	environment
epinions	science
painting	geography
committed	biology
extensive	politics
affordable	geography
universe	environment
candidate	biology
databases	politics
patent	environment
slot	biology
psp	sports
outstanding	religion
ha	science
eating	environment
perspective	politics
planned	environment
watching	sports
lodge	culture
messenger	environment
mirror	biology
tournament	geography
consideration	culture
ds	biology
discounts	culture
sterling	geography
sessions	culture
kernel	politics
boobs	biology
stocks	sports
buyers	biology
journals	culture
gray	religion
catalogue	religion
ea	science
jennifer	sports
antonio	politics
charged	culture
broad	politics
taiwan	environment
und	politics
chosen	geography
demo	biology
greece	geography
lg	politics
swiss	sports
sarah	religion
clark	culture
labour	environment
hate	environment
terminal	science
publishers	culture
nights	sports
behalf	geography
caribbean	sports
liquid	science
rice	culture
nebraska	environment
loop	sports
salary	politics
reservation	religion
foods	sports
gourmet	biology
guard	environment
properly	biology
orleans	religion
saving	biology
nfl	science
remaining	science
empire	geography
resume	culture
twenty	geography
newly	science
raise	geography
prepare	science
avatar	environment
gary	environment
depending	biology
illegal	sports
expansion	biology
vary	environment
hundreds	politics
rome	sports
arab	biology
lincoln	sports
helped	politics
premier	religion
tomorrow	religion
purchased	culture
milk	biology
decide	politics
consent	science
drama	biology
visiting	environment
performing	geography
downtown	culture
keyboard	sports
contest	geography
collected	environment
nw	culture
bands	biology
boot	sports
suitable	politics
ff	geography
absolutely	biology
millions	science
lunch	biology
dildo	religion
audit	sports
push	science
chamber	sports
guinea	science
findings	science
muscle	culture
featuring	religion
iso	biology
implement	culture
clicking	politics
scheduled	sports
polls	politics
typical	politics
tower	sports
yours	geography
sum	religion
misc	religion
calculator	biology
significantly	politics
chicken	geography
temporary	environment
attend	religion
shower	sports
alan	culture
sending	science
jason	religion
tonight	culture
dear	environment
sufficient	environment
holdem	religion
shell	science
province	science
catholic	geography
oak	sports
vat	environment
awareness	religion
vancouver	culture
governor	culture
beer	culture
seemed	environment
contribution	environment
measurement	biology
swimming	biology
spyware	biology
formula	politics
constitution	sports
packaging	science
solar	politics
jose	geography
catch	sports
jane	environment
pakistan	biology
ps	biology
reliable	science
consultation	politics
northwest	sports
sir	culture
doubt	environment
earn	geography
finder	science
unable	geography
periods	environment
classroom	biology
tasks	religion
democracy	sports
attacks	science
kim	politics
wallpaper	geography
merchandise	religion
const	culture
resistance	environment
doors	culture
symptoms	environment
resorts	biology
biggest	environment
memorial	biology
visitor	environment
twin	science
forth	geography
insert	religion
baltimore	science
gateway	culture
ky	culture
dont	sports
alumni	geography
drawing	politics
candidates	science
charlotte	politics
ordered	science
biological	culture
fighting	culture
transition	science
happens	geography
preferences	science
spy	biology
romance	science
instrument	geography
bruce	politics
split	science
themes	politics
powers	politics
heaven	biology
br	geography
bits	culture
pregnant	religion
twice	environment
classification	environment
focused	environment
egypt	religion
physician	culture
hollywood	sports
bargain	geography
wikipedia	religion
cellular	religion
norway	environment
vermont	sports
asking	politics
blocks	science
normally	science
lo	biology
spiritual	science
hunting	environment
diabetes	culture
suit	geography
ml	culture
shift	politics
chip	biology
res	culture
sit	politics
bodies	science
photographs	environment
cutting	politics
wow	culture
simon	culture
writers	religion
marks	geography
flexible	science
loved	culture
favourites	sports
mapping	politics
numerous	geography
relatively	science
birds	politics
satisfaction	biology
represents	environment
char	geography
indexed	environment
pittsburgh	biology
superior	sports
preferred	religion
saved	sports
paying	science
cartoon	geography
shots	politics
intellectual	sports
moore	sports
granted	politics
choices	science
carbon	culture
spending	biology
comfortable	biology
magnetic	religion
interaction	environment
listening	culture
effectively	geography
registry	environment
crisis	sports
outlook	religion
massive	biology
denmark	science
employed	sports
bright	politics
treat	environment
header	geography
cs	sports
poverty	culture
formed	geography
piano	biology
echo	geography
que	biology
grid	sports
sheets	sports
patrick	geography
experimental	religion
puerto	politics
revolution	religion
consolidation	biology
displays	science
plasma	geography
allowing	biology
earnings	sports
voip	science
mystery	environment
landscape	geography
dependent	science
mechanical	sports
journey	religion
delaware	culture
bidding	religion
consultants	geography
risks	culture
banner	religion
applicant	religion
charter	environment
fig	sports
barbara	sports
cooperation	culture
counties	culture
acquisition	science
ports	culture
implemented	science
sf	culture
directories	sports
recognized	biology
dreams	politics
blogger	science
notification	biology
kg	biology
licensing	geography
stands	biology
teach	culture
occurred	politics
textbooks	culture
rapid	science
pull	geography
hairy	geography
diversity	science
cleveland	culture
ut	politics
reverse	religion
deposit	culture
seminar	culture
investments	science
latina	geography
nasa	sports
wheels	environment
sexcam	science
specify	science
accessibility	biology
dutch	sports
sensitive	science
templates	culture
formats	environment
tab	environment
depends	religion
boots	science
holds	biology
router	science
concrete	sports
si	science
editing	geography
poland	science
folder	religion
womens	culture
css	geography
completion	politics
upload	culture
pulse	sports
universities	culture
technique	science
contractors	geography
milfhunter	geography
voting	culture
courts	sports
notices	geography
subscriptions	religion
calculate	geography
mc	sports
detroit	sports
alexander	environment
broadcast	sports
converted	culture
metro	politics
toshiba	politics
anniversary	culture
improvements	environment
strip	environment
specification	environment
pearl	environment
accident	biology
nick	culture
accessible	politics
accessory	geography
resident	environment
plot	politics
qty	politics
possibly	science
airline	biology
typically	geography
representation	science
regard	sports
pump	sports
exists	science
arrangements	religion
smooth	religion
conferences	culture
uniprotkb	religion
beastiality	politics
strike	religion
consumption	culture
birmingham	politics
flashing	politics
lp	environment
narrow	sports
afternoon	science
threat	science
surveys	politics
sitting	biology
putting	biology
consultant	science
controller	environment
ownership	politics
committees	politics
penis	religion
legislative	science
researchers	politics
vietnam	environment
trailer	sports
anne	environment
castle	religion
gardens	geography
missed	biology
malaysia	geography
unsubscribe	religion
antique	environment
labels	geography
willing	culture
bio	geography
molecular	biology
upskirt	geography
acting	environment
heads	politics
stored	sports
exam	biology
logos	politics
residence	sports
attorneys	religion
milfs	politics
antiques	environment
density	sports
hundred	culture
ryan	science
operators	religion
strange	geography
sustainable	science
philippines	culture
statistical	religion
beds	religion
breasts	religion
mention	politics
innovation	culture
pcs	culture
employers	environment
grey	politics
parallel	geography
honda	sports
amended	biology
operate	culture
bills	politics
bold	religion
bathroom	biology
stable	culture
opera	politics
definitions	science
von	religion
doctors	sports
lesson	geography
cinema	geography
asset	religion
ag	geography
scan	geography
elections	geography
drinking	religion
blowjobs	politics
reaction	religion
blank	culture
enhanced	science
entitled	environment
severe	environment
generate	religion
stainless	religion
newspapers	environment
hospitals	environment
vi	environment
deluxe	science
humor	geography
aged	religion
monitors	science
exception	science
lived	culture
duration	science
bulk	geography
successfully	environment
indonesia	environment
pursuant	geography
sci	politics
fabric	biology
edt	environment
visits	biology
primarily	culture
tight	religion
domains	religion
capabilities	religion
pmid	religion
contrast	geography
recommendation	environment
flying	science
recruitment	sports
sin	environment
berlin	politics
cute	biology
organized	sports
ba	religion
para	geography
siemens	politics
adoption	culture
improving	sports
cr	culture
expensive	culture
meant	culture
capture	biology
pounds	culture
buffalo	environment
organisations	culture
plane	science
pg	politics
explained	biology
seed	geography
programmes	religion
desire	biology
expertise	biology
mechanism	sports
camping	culture
ee	religion
jewellery	geography
meets	biology
welfare	geography
peer	politics
caught	geography
eventually	religion
marked	environment
driven	environment
measured	geography
medline	biology
bottle	geography
agreements	biology
considering	culture
innovative	sports
marshall	environment
massage	religion
rubber	biology
conclusion	religion
closing	religion
tampa	environment
thousand	geography
meat	politics
legend	religion
grace	politics
susan	geography
ing	religion
ks	biology
adams	religion
python	culture
monster	biology
alex	environment
bang	culture
villa	biology
bone	science
columns	sports
disorders	sports
bugs	geography
collaboration	politics
hamilton	geography
detection	religion
ftp	politics
cookies	culture
inner	politics
formation	biology
tutorial	biology
med	culture
engineers	environment
entity	politics
cruises	culture
gate	politics
holder	environment
proposals	religion
moderator	science
sw	environment
tutorials	religion
settlement	culture
portugal	science
lawrence	science
roman	religion
duties	religion
valuable	biology
erotic	environment
tone	sports
collectables	sports
ethics	biology
forever	sports
dragon	environment
busy	science
captain	environment
fantastic	environment
imagine	politics
brings	religion
heating	geography
leg	culture
neck	geography
hd	sports
wing	culture
governments	biology
purchasing	sports
scripts	politics
abc	science
stereo	religion
appointed	religion
taste	science
dealing	politics
commit	religion
tiny	science
operational	religion
rail	biology
airlines	science
liberal	culture
livecam	science
jay	culture
trips	science
gap	religion
sides	politics
tube	culture
turns	politics
corresponding	environment
descriptions	culture
cache	geography
belt	religion
jacket	culture
determination	religion
animation	environment
oracle	science
er	geography
matthew	sports
lease	geography
productions	geography
aviation	science
hobbies	culture
proud	culture
excess	environment
disaster	culture
console	geography
commands	environment
jr	environment
telecommunications	sports
instructor	culture
giant	environment
achieved	religion
injuries	politics
shipped	sports
bestiality	culture
seats	biology
approaches	science
biz	biology
alarm	religion
voltage	religion
anthony	culture
nintendo	sports
usual	religion
loading	geography
stamps	biology
appeared	biology
franklin	sports
angle	geography
rob	environment
vinyl	religion
highlights	culture
mining	geography
designers	religion
melbourne	sports
ongoing	biology
worst	geography
imaging	geography
betting	biology
scientists	environment
liberty	sports
wyoming	geography
blackjack	geography
argentina	science
era	science
convert	biology
possibility	sports
analyst	culture
commissioner	environment
dangerous	politics
garage	geography
exciting	biology
reliability	culture
thongs	environment
gcc	sports
unfortunately	religion
respectively	culture
volunteers	biology
attachment	environment
ringtone	religion
finland	culture
morgan	religion
derived	geography
pleasure	sports
honor	environment
asp	biology
oriented	science
eagle	geography
desktops	biology
pants	culture
columbus	politics
nurse	culture
prayer	sports
appointment	religion
workshops	biology
hurricane	sports
quiet	culture
luck	geography
postage	culture
producer	environment
represented	sports
mortgages	environment
dial	biology
responsibilities	culture
cheese	religion
comic	geography
carefully	culture
jet	geography
productivity	sports
investors	science
crown	culture
par	science
underground	science
diagnosis	science
maker	science
crack	politics
principle	sports
picks	science
vacations	culture
gang	religion
semester	religion
calculated	culture
cumshot	culture
fetish	politics
applies	science
casinos	politics
appearance	culture
smoke	environment
apache	sports
filters	sports
incorporated	geography
nv	geography
craft	politics
cake	environment
notebooks	geography
apart	politics
fellow	culture
blind	science
lounge	environment
mad	politics
algorithm	politics
semi	culture
coins	politics
andy	science
gross	culture
strongly	geography
cafe	biology
valentine	culture
hilton	environment
ken	culture
proteins	biology
horror	religion
su	politics
exp	biology
familiar	sports
capable	religion
douglas	religion
debian	religion
till	politics
involving	religion
pen	biology
investing	science
christopher	biology
admission	sports
epson	sports
shoe	science
elected	science
carrying	culture
victory	geography
sand	biology
madison	religion
terrorism	politics
joy	geography
editions	culture
cpu	religion
mainly	sports
ethnic	geography
ran	religion
parliament	politics
actor	sports
finds	environment
seal	science
situations	biology
fifth	environment
allocated	geography
citizen	religion
vertical	biology
corrections	sports
structural	biology
municipal	culture
describes	environment
prize	geography
sr	science
occurs	culture
jon	sports
absolute	culture
disabilities	culture
consists	culture
anytime	environment
substance	politics
prohibited	culture
addressed	politics
lies	environment
pipe	culture
soldiers	sports
nr	science
guardian	geography
lecture	biology
simulation	biology
layout	politics
initiatives	science
ill	religion
concentration	geography
classics	religion
lbs	environment
lay	science
interpretation	culture
horses	culture
lol	science
dirty	geography
deck	geography
wayne	religion
donate	culture
taught	biology
bankruptcy	sports
mp	politics
worker	politics
optimization	religion
alive	environment
temple	environment
substances	religion
prove	biology
discovered	politics
wings	biology
breaks	environment
genetic	politics
restrictions	religion
participating	biology
waters	culture
promise	sports
thin	culture
exhibition	culture
prefer	sports
ridge	politics
cabinet	religion
modem	environment
harris	geography
mph	environment
bringing	environment
sick	politics
dose	culture
evaluate	politics
tiffany	biology
tropical	sports
collect	science
bet	sports
composition	geography
toyota	religion
streets	religion
nationwide	sports
vector	biology
definitely	religion
shaved	biology
turning	religion
buffer	religion
purple	biology
existence	biology
commentary	sports
larry	science
limousines	biology
developments	science
def	culture
immigration	geography
destinations	sports
lets	science
mutual	politics
pipeline	sports
necessarily	sports
syntax	politics
li	religion
attribute	sports
prison	sports
skill	politics
chairs	religion
nl	religion
everyday	geography
apparently	environment
surrounding	geography
mountains	politics
moves	biology
popularity	geography
inquiry	politics
ethernet	culture
checked	environment
exhibit	geography
throw	sports
trend	environment
sierra	science
visible	sports
cats	geography
desert	geography
postposted	religion
ya	politics
oldest	politics
rhode	biology
nba	sports
busty	biology
coordinator	environment
obviously	geography
mercury	geography
steven	politics
handbook	sports
greg	culture
navigate	biology
worse	sports
summit	culture
victims	politics
epa	science
spaces	politics
fundamental	environment
burning	politics
escape	politics
coupons	sports
somewhat	religion
receiver	environment
substantial	science
tr	biology
progressive	geography
cialis	geography
bb	politics
boats	science
glance	science
scottish	environment
championship	geography
arcade	religion
richmond	biology
sacramento	politics
impossible	geography
ron	culture
russell	politics
tells	sports
obvious	environment
fiber	environment
depression	science
graph	sports
covering	religion
platinum	environment
judgment	politics
bedrooms	politics
talks	geography
filing	religion
foster	environment
modeling	culture
passing	politics
awarded	religion
testimonials	sports
trials	biology
tissue	biology
nz	religion
memorabilia	sports
clinton	science
masters	biology
bonds	environment
cartridge	culture
alberta	religion
explanation	culture
folk	religion
org	geography
commons	geography
cincinnati	science
subsection	geography
fraud	religion
electricity	culture
permitted	science
spectrum	geography
arrival	biology
okay	environment
pottery	sports
emphasis	geography
roger	sports
aspect	politics
workplace	politics
awesome	religion
mexican	science
confirmed	biology
counts	science
priced	biology
wallpapers	environment
hist	environment
crash	culture
lift	biology
desired	biology
inter	biology
closer	religion
assumes	culture
heights	politics
shadow	sports
riding	biology
infection	environment
firefox	religion
lisa	geography
expense	biology
grove	biology
eligibility	politics
venture	geography
clinic	religion
korean	geography
healing	culture
princess	science
mall	science
entering	geography
packet	culture
spray	geography
studios	sports
involvement	geography
dad	sports
buttons	biology
placement	politics
observations	biology
vbulletin	science
funded	science
thompson	religion
winners	religion
extend	geography
roads	sports
subsequent	religion
pat	religion
dublin	religion
rolling	biology
fell	sports
motorcycle	environment
yard	biology
disclosure	politics
establishment	culture
memories	religion
nelson	culture
te	politics
arrived	culture
creates	science
faces	sports
tourist	sports
cocks	science
av	science
mayor	geography
murder	politics
sean	religion
adequate	religion
senator	politics
yield	biology
presentations	environment
grades	religion
cartoons	religion
pour	environment
digest	religion
reg	religion
lodging	politics
tion	geography
dust	environment
hence	sports
wiki	biology
entirely	science
replaced	religion
radar	culture
rescue	sports
undergraduate	geography
losses	biology
combat	science
reducing	politics
stopped	sports
occupation	culture
lakes	environment
butt	geography
donations	culture
associations	geography
citysearch	culture
closely	science
radiation	sports
diary	culture
seriously	biology
kings	geography
shooting	geography
kent	environment
adds	biology
nsw	culture
ear	environment
flags	science
pci	science
baker	science
launched	environment
elsewhere	biology
pollution	sports
conservative	religion
guestbook	biology
shock	politics
effectiveness	science
walls	biology
abroad	biology
ebony	politics
tie	culture
ward	culture
drawn	sports
arthur	science
ian	politics
visited	culture
roof	sports
walker	culture
demonstrate	environment
atmosphere	sports
suggests	science
kiss	politics
beast	biology
ra	environment
operated	culture
experiment	science
targets	science
overseas	religion
purchases	science
dodge	religion
counsel	environment
federation	sports
pizza	science
invited	biology
yards	sports
assignment	sports
chemicals	environment
gordon	biology
mod	politics
farmers	culture
rc	culture
queries	biology
bmw	sports
rush	biology
ukraine	culture
absence	religion
nearest	sports
cluster	religion
vendors	sports
mpeg	culture
whereas	politics
yoga	science
serves	politics
woods	biology
surprise	culture
lamp	sports
rico	culture
partial	science
shoppers	sports
phil	culture
everybody	politics
couples	religion
nashville	science
ranking	geography
jokes	science
cst	culture
http	science
ceo	biology
simpson	science
twiki	politics
sublime	environment
counseling	sports
palace	environment
acceptable	sports
satisfied	environment
glad	environment
wins	geography
measurements	geography
verify	religion
globe	sports
trusted	environment
copper	environment
milwaukee	biology
rack	religion
medication	religion
warehouse	culture
shareware	environment
ec	geography
rep	religion
dicke	politics
kerry	geography
receipt	culture
supposed	biology
ordinary	biology
nobody	sports
ghost	biology
violation	science
configure	religion
stability	culture
mit	biology
applying	culture
southwest	science
boss	religion
pride	biology
institutional	biology
expectations	biology
independence	politics
knowing	environment
reporter	culture
metabolism	politics
keith	politics
champion	biology
cloudy	sports
linda	environment
ross	geography
personally	sports
chile	culture
anna	science
plenty	biology
solo	sports
sentence	biology
throat	geography
ignore	science
maria	religion
uniform	biology
excellence	religion
wealth	environment
tall	environment
rm	geography
somewhere	biology
vacuum	biology
dancing	science
attributes	culture
recognize	religion
brass	geography
writes	biology
plaza	geography
pdas	politics
outcomes	culture
survival	sports
quest	culture
publish	culture
sri	sports
screening	politics
toe	science
thumbnail	science
trans	science
jonathan	geography
whenever	environment
nova	biology
lifetime	environment
api	biology
pioneer	politics
booty	geography
forgotten	science
acrobat	science
plates	sports
acres	culture
venue	politics
athletic	sports
thermal	science
essays	religion
behaviour	environment
vital	science
telling	science
fairly	biology
coastal	sports
config	sports
cf	sports
charity	politics
intelligent	science
edinburgh	science
vt	religion
excel	science
modes	environment
obligation	sports
campbell	sports
wake	biology
stupid	sports
harbor	religion
hungary	environment
traveler	sports
urw	biology
segment	sports
realize	politics
regardless	geography
lan	environment
enemy	biology
puzzle	sports
rising	environment
aluminum	biology
wells	politics
wishlist	environment
opens	politics
insight	biology
sms	science
shit	religion
restricted	environment
republican	environment
secrets	geography
lucky	culture
latter	environment
merchants	biology
thick	geography
trailers	politics
repeat	science
syndrome	politics
philips	environment
attendance	religion
penalty	religion
drum	sports
glasses	politics
enables	culture
nec	sports
iraqi	biology
builder	politics
vista	religion
jessica	science
chips	sports
terry	environment
flood	religion
foto	politics
ease	politics
arguments	biology
amsterdam	science
orgy	environment
arena	science
adventures	biology
pupils	biology
stewart	sports
announcement	culture
tabs	religion
outcome	religion
xx	science
appreciate	sports
expanded	sports
casual	environment
grown	environment
polish	sports
lovely	politics
extras	culture
gm	science
centres	sports
jerry	religion
clause	biology
smile	biology
lands	politics
ri	politics
troops	environment
indoor	science
bulgaria	religion
armed	geography
broker	science
charger	sports
regularly	politics
believed	culture
pine	politics
cooling	science
tend	culture
gulf	culture
rt	sports
rick	sports
trucks	sports
cp	science
mechanisms	politics
divorce	religion
laura	environment
shopper	culture
tokyo	science
partly	science
nikon	sports
customize	politics
tradition	politics
candy	culture
pills	politics
tiger	culture
donald	sports
folks	science
sensor	sports
exposed	sports
telecom	culture
hunt	religion
angels	science
deputy	biology
indicators	politics
sealed	religion
thai	sports
emissions	culture
physicians	geography
loaded	science
fred	environment
complaint	sports
scenes	politics
experiments	science
balls	geography
afghanistan	culture
dd	sports
boost	environment
spanking	religion
scholarship	culture
governance	sports
mill	culture
founded	geography
supplements	biology
chronic	sports
icons	science
tranny	religion
moral	science
den	geography
catering	geography
aud	biology
finger	politics
keeps	culture
pound	religion
locate	geography
camcorder	environment
pl	environment
trained	culture
burn	culture
implementing	environment
roses	biology
labs	sports
ourselves	politics
bread	geography
tobacco	science
wooden	sports
motors	sports
tough	science
roberts	politics
incident	environment
gonna	culture
dynamics	culture
lie	geography
crm	environment
rf	environment
conversation	science
decrease	politics
cumshots	culture
chest	religion
pension	religion
billy	politics
revenues	environment
emerging	science
worship	religion
bukkake	religion
capability	biology
ak	politics
fe	religion
craig	politics
herself	politics
producing	biology
churches	geography
precision	biology
damages	religion
reserves	geography
contributed	culture
solve	environment
shorts	geography
reproduction	politics
minority	politics
td	culture
diverse	science
amp	geography
ingredients	environment
sb	geography
ah	biology
johnny	culture
sole	religion
franchise	science
recorder	biology
complaints	science
facing	environment
sm	environment
nancy	religion
promotions	science
tones	environment
passion	sports
rehabilitation	sports
maintaining	science
sight	religion
laid	biology
clay	geography
defence	religion
patches	culture
weak	culture
refund	biology
usc	sports
towns	religion
environments	politics
trembl	religion
divided	religion
blvd	sports
reception	culture
amd	biology
wise	politics
emails	environment
cyprus	culture
wv	religion
odds	environment
correctly	science
insider	biology
seminars	geography
consequences	culture
makers	religion
hearts	biology
geography	religion
appearing	geography
integrity	sports
worry	science
ns	religion
discrimination	religion
eve	culture
carter	sports
legacy	science
marc	science
pleased	environment
danger	religion
vitamin	religion
widely	environment
processed	sports
phrase	politics
genuine	science
raising	geography
implications	environment
functionality	culture
paradise	biology
hybrid	religion
reads	biology
roles	culture
intermediate	religion
emotional	biology
sons	science
leaf	sports
pad	religion
glory	geography
platforms	politics
ja	science
bigger	biology
billing	culture
diesel	religion
versus	environment
combine	geography
overnight	culture
geographic	politics
exceed	politics
bs	culture
rod	environment
saudi	environment
fault	science
cuba	culture
hrs	culture
preliminary	environment
districts	politics
introduce	environment
silk	geography
promotional	religion
kate	science
chevrolet	biology
babies	politics
bi	sports
karen	environment
compiled	politics
romantic	politics
revealed	sports
specialists	culture
generator	biology
albert	politics
examine	sports
jimmy	science
graham	geography
suspension	culture
bristol	geography
margaret	geography
compaq	geography
sad	culture
correction	religion
wolf	culture
slowly	culture
authentication	biology
communicate	religion
rugby	culture
supplement	sports
showtimes	culture
cal	sports
portions	culture
infant	politics
promoting	biology
sectors	politics
samuel	science
fluid	religion
grounds	culture
fits	science
kick	biology
regards	biology
meal	culture
ta	geography
hurt	environment
machinery	science
bandwidth	sports
unlike	sports
equation	biology
baskets	culture
probability	geography
pot	biology
dimension	politics
wright	culture
img	environment
barry	sports
proven	biology
schedules	sports
admissions	religion
cached	science
warren	sports
slip	biology
studied	culture
reviewer	religion
involves	culture
quarterly	sports
rpm	science
profits	science
devil	culture
grass	culture
comply	geography
marie	politics
florist	geography
illustrated	politics
cherry	science
continental	politics
alternate	environment
deutsch	sports
achievement	geography
limitations	sports
kenya	biology
webcam	science
cuts	politics
funeral	culture
nutten	culture
earrings	culture
enjoyed	religion
automated	science
chapters	science
pee	biology
charlie	politics
quebec	politics
nipples	environment
passenger	sports
convenient	sports
dennis	culture
mars	politics
francis	science
tvs	sports
sized	religion
manga	sports
noticed	religion
socket	biology
silent	geography
literary	science
egg	religion
mhz	sports
signals	politics
caps	culture
orientation	biology
pill	environment
theft	science
childhood	geography
swing	religion
symbols	environment
lat	culture
meta	biology
humans	sports
analog	culture
facial	politics
choosing	sports
talent	science
dated	religion
flexibility	environment
seeker	science
wisdom	sports
shoot	geography
boundary	environment
mint	biology
packard	politics
offset	religion
payday	culture
philip	biology
elite	biology
gi	sports
spin	sports
holders	culture
believes	biology
swedish	environment
poems	environment
deadline	culture
jurisdiction	science
robot	biology
displaying	culture
witness	culture
collins	religion
equipped	science
stages	politics
encouraged	science
sur	politics
winds	science
powder	science
broadway	politics
acquired	science
assess	culture
wash	religion
cartridges	biology
stones	science
entrance	geography
gnome	sports
roots	geography
declaration	biology
losing	science
attempts	politics
gadgets	religion
noble	environment
glasgow	biology
automation	environment
impacts	geography
rev	environment
gospel	politics
advantages	politics
shore	biology
loves	culture
induced	geography
ll	environment
knight	environment
preparing	culture
loose	geography
aims	environment
recipient	politics
linking	sports
extensions	religion
appeals	politics
cl	sports
earned	science
illness	biology
islamic	geography
athletics	politics
southeast	environment
ieee	religion
ho	environment
alternatives	culture
pending	geography
parker	politics
determining	science
lebanon	culture
corp	science
personalized	politics
kennedy	sports
gt	environment
sh	sports
conditioning	politics
teenage	environment
soap	geography
ae	religion
triple	environment
cooper	culture
nyc	sports
vincent	environment
jam	science
secured	sports
unusual	religion
answered	culture
partnerships	religion
destruction	biology
slots	environment
increasingly	biology
migration	sports
disorder	politics
routine	politics
toolbar	religion
basically	environment
rocks	sports
conventional	sports
titans	religion
applicants	biology
wearing	religion
axis	biology
sought	science
genes	science
mounted	sports
habitat	biology
firewall	culture
median	geography
guns	science
scanner	science
herein	biology
occupational	sports
animated	science
horny	politics
judicial	environment
rio	sports
hs	biology
adjustment	sports
hero	science
integer	culture
treatments	religion
bachelor	religion
attitude	religion
camcorders	science
engaged	science
falling	geography
basics	politics
montreal	geography
carpet	religion
rv	culture
struct	geography
lenses	environment
binary	geography
genetics	politics
attended	politics
difficulty	biology
punk	religion
collective	religion
coalition	sports
pi	biology
dropped	sports
enrollment	culture
duke	religion
walter	religion
ai	biology
pace	culture
besides	sports
wage	science
producers	sports
ot	culture
collector	culture
arc	religion
hosts	environment
interfaces	culture
advertisers	science
moments	culture
atlas	politics
strings	politics
dawn	culture
representing	sports
observation	sports
feels	science
torture	environment
carl	sports
deleted	biology
coat	environment
mitchell	culture
mrs	biology
rica	environment
restoration	environment
convenience	sports
returning	environment
ralph	sports
opposition	politics
container	politics
yr	sports
defendant	environment
warner	culture
confirmation	politics
app	religion
embedded	biology
inkjet	geography
supervisor	sports
wizard	religion
corps	biology
actors	science
liver	religion
peripherals	culture
liable	religion
brochure	environment
morris	politics
bestsellers	politics
petition	geography
eminem	culture
recall	sports
antenna	politics
picked	environment
assumed	politics
departure	biology
minneapolis	science
belief	biology
killing	geography
bikini	religion
memphis	environment
shoulder	religion
decor	environment
lookup	politics
texts	politics
harvard	religion
brokers	politics
roy	geography
ion	environment
diameter	politics
ottawa	geography
doll	science
ic	culture
podcast	science
tit	biology
seasons	environment
peru	culture
interactions	science
refine	science
bidder	culture
singer	geography
evans	culture
herald	religion
literacy	culture
fails	sports
aging	politics
nike	biology
intervention	biology
pissing	science
fed	geography
plugin	science
attraction	culture
diving	geography
invite	sports
modification	politics
alice	religion
latinas	politics
suppose	environment
customized	politics
reed	culture
involve	religion
moderate	religion
terror	sports
younger	environment
thirty	environment
mice	science
opposite	geography
understood	politics
rapidly	religion
dealtime	environment
ban	environment
temp	culture
intro	geography
mercedes	biology
zus	environment
assurance	biology
fisting	biology
clerk	religion
happening	politics
vast	geography
mills	environment
outline	biology
amendments	religion
tramadol	sports
holland	environment
receives	science
jeans	sports
metropolitan	culture
compilation	environment
verification	sports
fonts	sports
ent	geography
odd	politics
wrap	environment
refers	culture
mood	biology
favor	religion
veterans	sports
quiz	politics
mx	geography
sigma	science
gr	politics
attractive	religion
xhtml	culture
occasion	environment
recordings	culture
jefferson	science
victim	geography
demands	environment
sleeping	religion
careful	religion
ext	politics
beam	politics
gardening	sports
obligations	politics
arrive	religion
orchestra	science
sunset	biology
tracked	environment
moreover	environment
minimal	environment
polyphonic	sports
lottery	politics
tops	religion
framed	geography
aside	geography
outsourcing	politics
licence	environment
adjustable	culture
allocation	culture
michelle	sports
essay	culture
discipline	sports
amy	sports
ts	sports
demonstrated	politics
dialogue	biology
identifying	culture
alphabetical	politics
camps	sports
declared	biology
dispatched	culture
aaron	religion
handheld	biology
trace	religion
disposal	religion
shut	geography
florists	geography
packs	religion
ge	sports
installing	environment
switches	geography
romania	sports
voluntary	geography
ncaa	biology
thou	sports
consult	science
phd	science
greatly	sports
blogging	culture
mask	politics
cycling	culture
midnight	religion
ng	religion
commonly	sports
pe	biology
photographer	geography
inform	environment
turkish	religion
coal	politics
cry	politics
messaging	religion
pentium	geography
quantum	politics
murray	culture
intent	environment
tt	biology
zoo	politics
largely	science
pleasant	religion
announce	environment
constructed	culture
additions	science
requiring	environment
spoke	science
aka	science
arrow	religion
engagement	religion
sampling	environment
rough	sports
weird	science
tee	religion
refinance	environment
lion	environment
inspired	culture
holes	biology
weddings	culture
blade	environment
suddenly	biology
oxygen	environment
cookie	religion
meals	culture
canyon	environment
goto	sports
meters	geography
merely	environment
calendars	culture
arrangement	religion
conclusions	biology
passes	geography
bibliography	science
pointer	science
compatibility	religion
stretch	culture
durham	politics
furthermore	science
permits	science
cooperative	culture
muslim	environment
xl	science
neil	environment
sleeve	politics
netscape	science
cleaner	science
cricket	sports
beef	biology
feeding	sports
stroke	biology
township	geography
rankings	geography
measuring	religion
cad	politics
hats	religion
robin	science
robinson	culture
jacksonville	biology
strap	environment
headquarters	culture
sharon	politics
crowd	sports
tcp	environment
transfers	science
surf	politics
olympic	biology
transformation	science
remained	sports
attachments	environment
dv	geography
dir	science
entities	environment
customs	culture
administrators	politics
personality	religion
rainbow	religion
hook	science
roulette	biology
decline	biology
gloves	religion
israeli	environment
medicare	geography
cord	geography
skiing	geography
cloud	sports
facilitate	religion
subscriber	sports
valve	sports
val	environment
hewlett	politics
explains	politics
proceed	culture
flickr	culture
feelings	sports
knife	sports
jamaica	geography
priorities	environment
shelf	religion
bookstore	politics
timing	biology
liked	science
parenting	sports
adopt	sports
denied	geography
fotos	environment
incredible	environment
britney	environment
freeware	sports
fucked	culture
donation	sports
outer	science
crop	politics
deaths	science
rivers	politics
commonwealth	geography
pharmaceutical	environment
manhattan	sports
tales	biology
katrina	geography
workforce	geography
islam	culture
nodes	culture
tu	environment
fy	culture
thumbs	politics
seeds	biology
cited	culture
lite	politics
ghz	sports
hub	geography
targeted	geography
organizational	biology
skype	sports
realized	religion
twelve	geography
founder	environment
decade	geography
gamecube	religion
rr	politics
dispute	biology
portuguese	environment
tired	science
titten	religion
adverse	sports
everywhere	geography
excerpt	environment
eng	sports
steam	environment
discharge	culture
ef	biology
drinks	politics
ace	biology
voices	science
acute	culture
halloween	sports
climbing	science
stood	environment
sing	biology
tons	biology
perfume	religion
carol	science
honest	sports
albany	sports
hazardous	biology
restore	biology
stack	culture
methodology	culture
somebody	culture
sue	politics
ep	science
housewares	religion
reputation	environment
resistant	religion
democrats	culture
recycling	sports
hang	sports
gbp	biology
curve	geography
creator	culture
amber	culture
qualifications	culture
museums	sports
coding	sports
slideshow	biology
tracker	culture
variation	environment
passage	culture
transferred	science
trunk	culture
hiking	politics
lb	environment
damn	biology
pierre	biology
jelsoft	sports
headset	sports
photograph	politics
oakland	biology
colombia	geography
waves	sports
camel	sports
distributor	sports
lamps	biology
underlying	biology
hood	religion
wrestling	culture
suicide	sports
archived	culture
photoshop	culture
jp	culture
chi	sports
bt	environment
arabia	politics
gathering	biology
projection	politics
juice	culture
chase	geography
mathematical	biology
logical	culture
sauce	culture
fame	biology
extract	science
specialized	environment
diagnostic	sports
panama	sports
indianapolis	politics
af	science
payable	geography
corporations	culture
courtesy	environment
criticism	politics
automobile	science
confidential	culture
rfc	biology
statutory	science
accommodations	religion
athens	science
northeast	sports
downloaded	geography
judges	politics
sl	religion
seo	biology
retired	environment
isp	sports
remarks	science
detected	politics
decades	sports
paintings	biology
walked	politics
arising	culture
nissan	geography
bracelet	culture
ins	biology
eggs	biology
juvenile	science
injection	politics
yorkshire	science
populations	geography
protective	geography
afraid	religion
acoustic	politics
railway	sports
cassette	politics
initially	culture
indicator	science
pointed	religion
hb	religion
jpg	culture
causing	biology
mistake	religion
norton	geography
locked	politics
eliminate	politics
tc	sports
fusion	science
mineral	sports
sunglasses	geography
ruby	culture
steering	environment
beads	biology
fortune	religion
preference	science
canvas	religion
threshold	environment
parish	religion
claimed	sports
screens	culture
cemetery	environment
planner	biology
croatia	geography
flows	biology
stadium	politics
venezuela	environment
exploration	culture
mins	science
fewer	sports
sequences	culture
coupon	culture
nurses	sports
ssl	environment
stem	environment
proxy	environment
gangbang	science
astronomy	biology
lanka	politics
opt	sports
edwards	religion
drew	geography
contests	science
flu	religion
translate	biology
announces	science
mlb	science
costume	geography
tagged	environment
berkeley	biology
voted	biology
killer	geography
bikes	religion
gates	religion
adjusted	politics
rap	geography
tune	culture
bishop	science
pulled	environment
corn	geography
gp	religion
shaped	environment
compression	science
seasonal	politics
establishing	religion
farmer	sports
counters	environment
puts	geography
constitutional	biology
grew	environment
perfectly	culture
tin	biology
slave	geography
instantly	politics
cultures	science
norfolk	geography
coaching	sports
examined	science
trek	science
encoding	science
litigation	politics
submissions	religion
oem	environment
heroes	biology
painted	environment
lycos	politics
ir	biology
zdnet	geography
broadcasting	sports
horizontal	biology
artwork	culture
cosmetic	religion
resulted	culture
portrait	culture
terrorist	geography
informational	environment
ethical	geography
carriers	culture
ecommerce	environment
mobility	environment
floral	politics
builders	geography
ties	politics
struggle	culture
schemes	religion
suffering	geography
neutral	culture
fisher	biology
rat	environment
spears	environment
prospective	religion
dildos	sports
bedding	biology
ultimately	biology
joining	sports
heading	culture
equally	science
artificial	science
bearing	biology
spectacular	culture
coordination	politics
connector	religion
brad	geography
combo	religion
seniors	science
worlds	culture
guilty	science
affiliated	biology
activation	sports
naturally	religion
haven	sports
tablet	biology
jury	sports
dos	sports
tail	geography
subscribers	geography
charm	culture
lawn	religion
violent	culture
mitsubishi	biology
underwear	science
basin	religion
soup	biology
potentially	politics
ranch	politics
constraints	politics
crossing	geography
inclusive	science
dimensional	science
cottage	environment
drunk	environment
considerable	environment
crimes	politics
resolved	science
mozilla	culture
byte	sports
toner	geography
nose	science
latex	geography
branches	science
anymore	culture
oclc	politics
delhi	environment
holdings	geography
alien	biology
locator	science
selecting	environment
processors	sports
pantyhose	culture
plc	culture
broke	science
nepal	politics
zimbabwe	politics
difficulties	environment
juan	environment
complexity	environment
msg	religion
constantly	culture
browsing	biology
resolve	religion
barcelona	geography
presidential	science
documentary	religion
cod	religion
territories	politics
melissa	politics
moscow	science
thesis	environment
thru	culture
jews	geography
nylon	science
palestinian	biology
discs	culture
rocky	science
bargains	religion
frequent	culture
trim	geography
nigeria	religion
ceiling	culture
pixels	politics
ensuring	biology
hispanic	culture
cv	sports
cb	politics
legislature	environment
hospitality	science
gen	science
anybody	culture
procurement	sports
diamonds	politics
espn	religion
fleet	biology
untitled	biology
bunch	sports
totals	religion
marriott	politics
singing	culture
theoretical	environment
afford	environment
exercises	biology
starring	sports
referral	religion
nhl	sports
surveillance	politics
optimal	politics
quit	politics
distinct	sports
protocols	religion
lung	geography
highlight	culture
substitute	sports
inclusion	environment
hopefully	science
brilliant	sports
turner	culture
sucking	environment
cents	sports
reuters	geography
ti	science
fc	science
gel	sports
todd	politics
spoken	science
omega	science
evaluated	biology
stayed	sports
civic	science
assignments	religion
fw	science
manuals	science
doug	biology
sees	environment
termination	politics
watched	religion
saver	religion
thereof	politics
grill	politics
households	environment
gs	environment
redeem	geography
rogers	culture
grain	geography
aaa	biology
authentic	environment
regime	culture
wanna	culture
wishes	religion
bull	science
montgomery	politics
architectural	biology
louisville	geography
depend	geography
differ	religion
macintosh	environment
movements	sports
ranging	sports
monica	environment
repairs	environment
breath	environment
amenities	science
virtually	sports
cole	culture
mart	sports
candle	science
hanging	politics
colored	sports
authorization	culture
tale	biology
verified	religion
lynn	environment
formerly	geography
projector	culture
bp	biology
situated	geography
comparative	politics
std	geography
seeks	culture
herbal	politics
loving	geography
strictly	environment
routing	biology
docs	sports
stanley	biology
psychological	environment
surprised	science
retailer	environment
vitamins	geography
elegant	geography
gains	geography
renewal	politics
vid	culture
genealogy	sports
opposed	sports
deemed	biology
scoring	politics
expenditure	geography
panties	science
brooklyn	politics
liverpool	environment
sisters	geography
critics	sports
connectivity	culture
spots	politics
oo	sports
algorithms	culture
hacker	politics
madrid	science
similarly	biology
margin	religion
coin	culture
bbw	biology
solely	geography
fake	science
salon	biology
collaborative	environment
norman	geography
fda	science
excluding	religion
turbo	biology
headed	science
voters	science
cure	politics
madonna	culture
commander	environment
arch	religion
ni	science
murphy	geography
thinks	environment
thats	biology
suggestion	culture
hdtv	sports
soldier	politics
phillips	geography
asin	religion
aimed	culture
justin	politics
bomb	culture
harm	science
interval	culture
mirrors	geography
spotlight	politics
tricks	environment
reset	biology
brush	sports
investigate	religion
thy	geography
expansys	sports
panels	geography
repeated	science
assault	religion
connecting	culture
spare	environment
logistics	culture
deer	biology
kodak	sports
tongue	science
bowling	culture
tri	sports
danish	religion
pal	biology
monkey	science
proportion	biology
filename	politics
skirt	biology
florence	geography
invest	religion
honey	environment
um	religion
analyses	sports
drawings	politics
significance	politics
scenario	geography
ye	religion
fs	sports
lovers	religion
atomic	culture
approx	environment
symposium	sports
arabic	geography
gauge	culture
essentials	sports
junction	politics
protecting	culture
nn	science
faced	sports
mat	culture
rachel	politics
solving	environment
transmitted	environment
weekends	biology
screenshots	politics
produces	science
oven	sports
ted	religion
intensive	science
chains	religion
kingston	sports
sixth	religion
engage	environment
deviant	geography
noon	politics
switching	geography
quoted	culture
adapters	science
correspondence	biology
farms	geography
imports	science
supervision	geography
cheat	politics
bronze	geography
expenditures	sports
sandy	religion
separation	sports
testimony	geography
suspect	politics
celebrities	environment
macro	politics
sender	politics
mandatory	environment
boundaries	science
crucial	religion
syndication	culture
gym	sports
celebration	sports
kde	culture
adjacent	science
filtering	geography
tuition	geography
spouse	biology
exotic	sports
viewer	biology
signup	environment
threats	politics
luxembourg	environment
puzzles	biology
reaching	biology
vb	biology
damaged	religion
cams	sports
receptor	geography
piss	religion
laugh	biology
joel	sports
surgical	religion
destroy	geography
citation	religion
pitch	politics
autos	biology
yo	politics
premises	biology
perry	politics
proved	sports
offensive	geography
imperial	sports
dozen	culture
benjamin	culture
deployment	science
teeth	politics
cloth	science
studying	culture
colleagues	science
stamp	geography
lotus	religion
salmon	biology
olympus	biology
separated	sports
proc	biology
cargo	geography
tan	religion
directive	geography
fx	geography
salem	culture
mate	geography
dl	religion
starter	politics
upgrades	environment
likes	science
butter	biology
pepper	geography
weapon	environment
luggage	biology
burden	environment
chef	religion
tapes	science
zones	science
races	science
isle	biology
stylish	geography
slim	politics
maple	culture
luke	politics
grocery	biology
offshore	science
governing	religion
retailers	geography
depot	religion
kenneth	geography
comp	sports
alt	sports
pie	sports
blend	biology
harrison	religion
ls	culture
julie	environment
occasionally	geography
cbs	geography
attending	geography
emission	science
pete	science
spec	environment
finest	politics
realty	politics
janet	biology
bow	geography
penn	religion
recruiting	science
apparent	environment
instructional	biology
phpbb	geography
autumn	religion
traveling	science
probe	biology
midi	religion
permissions	science
biotechnology	sports
toilet	science
ranked	culture
jackets	religion
routes	culture
packed	science
excited	religion
outreach	biology
helen	environment
mounting	sports
recover	religion
tied	culture
lopez	geography
balanced	politics
prescribed	sports
catherine	science
timely	sports
talked	sports
upskirts	science
debug	sports
delayed	environment
chuck	politics
reproduced	culture
hon	environment
dale	biology
explicit	environment
calculation	geography
villas	religion
ebook	sports
consolidated	culture
boob	geography
exclude	environment
peeing	science
occasions	science
brooks	biology
equations	culture
newton	geography
oils	biology
sept	religion
exceptional	science
anxiety	environment
bingo	science
whilst	politics
spatial	science
respondents	science
unto	biology
lt	politics
ceramic	geography
prompt	politics
precious	science
minds	environment
annually	environment
considerations	biology
scanners	biology
atm	science
xanax	geography
eq	geography
pays	science
cox	religion
fingers	culture
sunny	environment
ebooks	science
delivers	geography
je	environment
queensland	culture
necklace	science
musicians	politics
leeds	culture
composite	religion
unavailable	environment
cedar	culture
arranged	sports
lang	politics
theaters	environment
advocacy	sports
raleigh	geography
stud	sports
fold	geography
essentially	religion
designing	science
threaded	politics
uv	science
qualify	culture
fingering	sports
blair	religion
hopes	politics
assessments	sports
cms	sports
mason	environment
diagram	politics
burns	sports
pumps	religion
slut	biology
ejaculation	politics
footwear	sports
sg	environment
vic	sports
beijing	politics
peoples	sports
victor	sports
mario	sports
pos	sports
attach	environment
licenses	politics
utils	geography
removing	religion
advised	environment
brunswick	biology
spider	science
phys	geography
ranges	science
pairs	environment
sensitivity	biology
trails	culture
preservation	religion
hudson	biology
isolated	culture
calgary	biology
interim	environment
assisted	environment
divine	religion
streaming	sports
approve	science
chose	geography
compound	biology
intensity	environment
technological	religion
syndicate	sports
abortion	biology
dialog	geography
venues	geography
blast	geography
wellness	science
calcium	biology
newport	geography
antivirus	biology
addressing	biology
pole	religion
discounted	culture
indians	politics
shield	culture
harvest	culture
membrane	environment
prague	religion
previews	biology
bangladesh	biology
constitute	sports
locally	environment
concluded	environment
pickup	politics
desperate	culture
mothers	biology
nascar	science
iceland	culture
demonstration	politics
governmental	politics
manufactured	culture
candles	science
graduation	sports
mega	politics
bend	biology
sailing	culture
variations	politics
moms	biology
sacred	biology
addiction	science
morocco	politics
chrome	religion
tommy	science
springfield	geography
refused	biology
brake	religion
exterior	geography
greeting	biology
ecology	politics
oliver	geography
congo	geography
glen	biology
botswana	geography
nav	environment
delays	geography
synthesis	biology
olive	culture
undefined	religion
unemployment	science
cyber	biology
verizon	environment
scored	geography
enhancement	culture
newcastle	culture
clone	biology
dicks	environment
velocity	politics
lambda	biology
relay	environment
composed	politics
tears	religion
performances	biology
oasis	science
baseline	sports
cab	environment
angry	science
fa	culture
societies	biology
silicon	sports
brazilian	politics
identical	religion
petroleum	religion
compete	biology
ist	geography
norwegian	biology
lover	science
belong	religion
honolulu	science
beatles	geography
lips	politics
escort	politics
retention	culture
exchanges	politics
pond	geography
rolls	biology
thomson	science
barnes	geography
soundtrack	religion
wondering	geography
malta	sports
daddy	religion
lc	geography
ferry	biology
rabbit	sports
profession	geography
seating	politics
dam	biology
cnn	environment
separately	politics
physiology	sports
lil	science
collecting	environment
das	biology
exports	politics
omaha	religion
tire	religion
participant	sports
scholarships	geography
recreational	environment
dominican	environment
chad	science
electron	geography
loads	biology
friendship	biology
heather	politics
passport	geography
motel	politics
unions	religion
treasury	science
warrant	biology
sys	culture
solaris	religion
frozen	environment
occupied	politics
josh	science
royalty	science
scales	biology
rally	culture
observer	culture
sunshine	science
strain	biology
drag	religion
ceremony	biology
somehow	science
arrested	culture
expanding	geography
provincial	culture
investigations	religion
icq	sports
ripe	biology
yamaha	environment
rely	science
medications	politics
hebrew	geography
gained	religion
rochester	science
dying	environment
laundry	religion
stuck	politics
solomon	religion
placing	politics
stops	biology
homework	sports
adjust	religion
assessed	culture
advertiser	sports
enabling	science
encryption	environment
filling	geography
downloadable	politics
sophisticated	environment
imposed	politics
silence	culture
scsi	environment
focuses	religion
soviet	science
possession	biology
cu	geography
laboratories	religion
treaty	politics
vocal	biology
trainer	environment
organ	religion
stronger	politics
volumes	science
advances	environment
vegetables	sports
lemon	biology
toxic	environment
dns	geography
thumbnails	politics
darkness	geography
pty	biology
ws	sports
nuts	culture
nail	religion
bizrate	culture
vienna	environment
implied	culture
span	environment
stanford	culture
sox	environment
stockings	biology
joke	sports
respondent	geography
packing	sports
statute	geography
rejected	culture
satisfy	sports
destroyed	science
shelter	geography
chapel	sports
gamespot	geography
manufacture	culture
layers	politics
wordpress	sports
guided	politics
vulnerability	religion
accountability	politics
celebrate	politics
accredited	sports
appliance	biology
compressed	biology
bahamas	biology
powell	politics
mixture	religion
zoophilia	environment
bench	politics
univ	environment
tub	religion
rider	geography
scheduling	politics
radius	geography
perspectives	politics
mortality	religion
logging	politics
hampton	environment
christians	biology
borders	biology
therapeutic	geography
pads	environment
butts	religion
inns	sports
bobby	environment
impressive	sports
sheep	biology
accordingly	religion
architect	politics
railroad	culture
lectures	sports
challenging	biology
wines	culture
nursery	sports
harder	biology
cups	religion
ash	science
microwave	culture
cheapest	politics
accidents	religion
travesti	biology
relocation	religion
stuart	science
contributors	religion
salvador	geography
ali	biology
salad	culture
np	biology
monroe	religion
tender	biology
violations	politics
foam	culture
temperatures	environment
paste	culture
clouds	science
competitions	biology
discretion	environment
tft	biology
tanzania	biology
preserve	environment
jvc	science
poem	religion
vibrator	religion
unsigned	culture
staying	biology
cosmetics	geography
easter	sports
theories	geography
repository	religion
praise	sports
jeremy	culture
venice	religion
jo	biology
concentrations	religion
vibrators	sports
estonia	sports
christianity	religion
veteran	religion
streams	environment
landing	geography
signing	biology
executed	biology
katie	religion
negotiations	religion
realistic	sports
dt	biology
cgi	religion
showcase	biology
integral	geography
asks	religion
relax	sports
namibia	religion
generating	science
christina	sports
congressional	politics
synopsis	religion
hardly	religion
prairie	geography
reunion	science
composer	politics
bean	religion
sword	geography
absent	religion
photographic	science
sells	politics
ecuador	sports
hoping	politics
accessed	religion
spirits	environment
modifications	biology
coral	sports
pixel	geography
float	geography
colin	biology
bias	culture
imported	science
paths	environment
bubble	politics
por	science
acquire	sports
contrary	culture
millennium	geography
tribune	religion
vessel	religion
acids	geography
focusing	science
viruses	geography
cheaper	politics
admitted	geography
dairy	sports
admit	culture
mem	environment
fancy	science
equality	environment
samoa	religion
gc	biology
achieving	culture
tap	biology
stickers	culture
fisheries	biology
exceptions	culture
reactions	biology
leasing	science
lauren	politics
beliefs	culture
ci	culture
macromedia	culture
companion	religion
squad	culture
analyze	culture
ashley	religion
scroll	science
relate	religion
divisions	science
swim	geography
wages	sports
additionally	politics
suffer	sports
forests	religion
fellowship	sports
nano	sports
invalid	sports
concerts	science
martial	science
males	environment
victorian	sports
retain	politics
colours	geography
execute	religion
tunnel	culture
genres	biology
cambodia	religion
patents	science
copyrights	environment
yn	geography
chaos	sports
lithuania	culture
mastercard	sports
wheat	geography
chronicles	geography
obtaining	geography
beaver	science
updating	religion
distribute	culture
readings	biology
decorative	environment
kijiji	politics
confused	environment
compiler	geography
enlargement	politics
eagles	religion
bases	politics
vii	sports
accused	culture
bee	sports
campaigns	culture
unity	politics
loud	sports
conjunction	sports
bride	geography
rats	religion
defines	geography
airports	science
instances	politics
indigenous	environment
begun	religion
cfr	sports
brunette	politics
packets	politics
anchor	biology
socks	science
validation	culture
parade	religion
corruption	science
stat	geography
trigger	science
incentives	sports
cholesterol	geography
gathered	environment
essex	biology
slovenia	sports
notified	sports
differential	geography
beaches	science
folders	geography
dramatic	sports
surfaces	science
terrible	culture
routers	politics
cruz	environment
pendant	biology
dresses	science
baptist	biology
scientist	biology
starsmerchant	environment
hiring	religion
clocks	biology
arthritis	environment
bios	culture
females	science
wallace	culture
nevertheless	politics
reflects	science
taxation	religion
fever	politics
pmc	culture
cuisine	sports
surely	environment
practitioners	politics
transcript	biology
myspace	environment
theorem	biology
inflation	environment
thee	geography
nb	biology
ruth	science
pray	religion
stylus	politics
compounds	geography
pope	science
drums	biology
contracting	science
topless	biology
arnold	science
structured	politics
reasonably	biology
jeep	religion
chicks	religion
bare	science
hung	religion
cattle	religion
mba	biology
radical	religion
graduates	environment
rover	science
recommends	religion
controlling	religion
treasure	sports
reload	science
distributors	biology
flame	culture
levitra	religion
tanks	science
assuming	politics
monetary	politics
elderly	sports
pit	politics
arlington	environment
mono	culture
particles	sports
floating	culture
extraordinary	biology
tile	culture
indicating	geography
bolivia	science
spell	environment
hottest	religion
stevens	politics
coordinate	politics
kuwait	culture
exclusively	geography
emily	geography
alleged	politics
limitation	environment
widescreen	geography
compile	science
squirting	science
webster	environment
struck	science
rx	culture
illustration	biology
plymouth	sports
warnings	environment
construct	culture
apps	sports
inquiries	science
bridal	biology
annex	politics
mag	politics
gsm	environment
inspiration	environment
tribal	religion
curious	environment
affecting	science
freight	geography
rebate	environment
meetup	biology
eclipse	sports
sudan	environment
ddr	environment
downloading	environment
rec	culture
shuttle	culture
aggregate	geography
stunning	environment
cycles	sports
affects	religion
forecasts	geography
detect	science
sluts	environment
actively	biology
ciao	politics
ampland	politics
knee	biology
prep	biology
pb	environment
complicated	science
chem	sports
fastest	religion
butler	politics
shopzilla	culture
injured	religion
decorating	environment
payroll	sports
cookbook	science
expressions	religion
ton	politics
courier	geography
uploaded	geography
shakespeare	environment
hints	environment
collapse	sports
americas	environment
connectors	environment
twinks	politics
unlikely	environment
oe	biology
gif	culture
pros	religion
conflicts	culture
techno	sports
beverage	geography
tribute	sports
wired	religion
elvis	culture
immune	religion
latvia	politics
travelers	sports
forestry	geography
barriers	culture
cant	biology
jd	culture
rarely	science
gpl	religion
infected	environment
offerings	science
martha	science
genesis	sports
barrier	environment
argue	environment
incorrect	biology
trains	environment
metals	culture
bicycle	environment
furnishings	religion
letting	sports
arise	sports
guatemala	culture
celtic	science
thereby	sports
irc	geography
jamie	culture
particle	politics
perception	geography
minerals	environment
advise	religion
humidity	culture
bottles	science
boxing	biology
wy	politics
dm	geography
bangkok	sports
renaissance	geography
pathology	sports
sara	geography
bra	culture
ordinance	politics
hughes	biology
photographers	geography
bitch	culture
infections	science
jeffrey	politics
chess	science
operates	politics
brisbane	geography
configured	science
survive	sports
oscar	politics
festivals	biology
menus	sports
joan	culture
possibilities	geography
duck	religion
reveal	religion
canal	biology
amino	sports
phi	culture
contributing	sports
herbs	science
clinics	environment
mls	biology
cow	religion
manitoba	culture
analytical	politics
missions	science
watson	environment
lying	science
costumes	sports
strict	environment
dive	politics
saddam	biology
circulation	biology
drill	science
offense	environment
threesome	politics
bryan	biology
cet	culture
protest	biology
handjob	sports
assumption	environment
jerusalem	culture
hobby	biology
tries	biology
transexuales	politics
invention	environment
nickname	geography
fiji	sports
technician	sports
inline	biology
executives	geography
enquiries	sports
washing	politics
audi	environment
staffing	geography
cognitive	environment
exploring	religion
trick	religion
enquiry	science
closure	geography
raid	culture
ppc	politics
timber	religion
volt	sports
intense	politics
div	religion
playlist	biology
registrar	sports
showers	politics
supporters	environment
ruling	culture
steady	religion
dirt	geography
statutes	science
withdrawal	culture
myers	environment
drops	sports
predicted	religion
wider	environment
saskatchewan	biology
jc	biology
cancellation	politics
plugins	environment
enrolled	science
sensors	religion
screw	religion
ministers	science
publicly	science
hourly	environment
blame	politics
geneva	religion
freebsd	religion
veterinary	religion
acer	biology
prostores	biology
reseller	sports
dist	environment
handed	environment
suffered	politics
intake	geography
informal	environment
relevance	biology
incentive	geography
butterfly	religion
tucson	biology
mechanics	culture
heavily	sports
swingers	geography
fifty	religion
headers	environment
mistakes	geography
numerical	environment
ons	environment
geek	sports
uncle	environment
defining	environment
xnxx	environment
counting	geography
reflection	culture
sink	environment
accompanied	religion
assure	politics
invitation	biology
devoted	sports
princeton	environment
jacob	science
sodium	politics
randy	culture
spirituality	science
hormone	geography
meanwhile	religion
proprietary	politics
timothy	culture
childrens	sports
brick	politics
grip	religion
naval	culture
thumbzilla	culture
medieval	environment
porcelain	biology
avi	religion
bridges	environment
pichunter	culture
captured	politics
watt	science
thehun	culture
decent	biology
casting	environment
dayton	science
translated	culture
shortly	geography
cameron	environment
columnists	culture
pins	biology
carlos	geography
reno	biology
donna	geography
andreas	geography
warrior	sports
diploma	politics
cabin	sports
innocent	biology
bdsm	culture
scanning	science
ide	geography
consensus	religion
polo	religion
valium	sports
copying	politics
rpg	science
delivering	science
cordless	culture
patricia	biology
horn	sports
eddie	sports
uganda	biology
fired	science
journalism	sports
pd	geography
prot	biology
trivia	biology
adidas	religion
perth	religion
frog	sports
grammar	geography
intention	geography
syria	biology
disagree	environment
klein	politics
harvey	geography
tires	geography
logs	science
undertaken	biology
tgp	sports
hazard	biology
retro	biology
leo	geography
livesex	biology
statewide	geography
semiconductor	environment
gregory	geography
episodes	biology
boolean	geography
circular	sports
anger	science
diy	sports
mainland	environment
illustrations	politics
suits	culture
chances	science
interact	biology
snap	science
happiness	politics
arg	geography
substantially	religion
bizarre	science
glenn	religion
ur	environment
auckland	geography
olympics	religion
fruits	religion
identifier	sports
geo	religion
worldsex	culture
ribbon	science
calculations	geography
doe	culture
jpeg	geography
conducting	biology
startup	environment
suzuki	sports
trinidad	biology
ati	culture
kissing	politics
wal	culture
handy	biology
swap	science
exempt	environment
crops	biology
reduces	sports
accomplished	politics
calculators	religion
geometry	politics
impression	biology
abs	environment
slovakia	geography
flip	culture
guild	sports
correlation	environment
gorgeous	religion
capitol	geography
sim	biology
dishes	culture
rna	politics
barbados	biology
chrysler	biology
nervous	culture
refuse	politics
extends	biology
fragrance	religion
mcdonald	geography
replica	sports
plumbing	science
brussels	science
tribe	sports
neighbors	environment
trades	culture
superb	biology
buzz	geography
transparent	environment
nuke	culture
rid	science
trinity	science
charleston	religion
handled	biology
legends	sports
boom	sports
calm	culture
champions	geography
floors	sports
selections	science
projectors	religion
inappropriate	environment
exhaust	geography
comparing	politics
shanghai	sports
speaks	science
burton	geography
vocational	religion
davidson	environment
copied	religion
scotia	geography
farming	politics
gibson	science
pharmacies	environment
fork	religion
troy	politics
ln	science
roller	culture
introducing	science
batch	environment
organize	culture
appreciated	sports
alter	geography
nicole	culture
latino	politics
ghana	religion
edges	environment
uc	culture
mixing	politics
handles	sports
skilled	science
fitted	politics
albuquerque	culture
harmony	sports
distinguished	politics
asthma	culture
projected	sports
assumptions	culture
shareholders	culture
twins	geography
developmental	politics
rip	biology
zope	biology
regulated	science
triangle	politics
amend	science
anticipated	geography
oriental	sports
reward	environment
windsor	geography
zambia	environment
completing	sports
gmbh	biology
buf	science
ld	politics
hydrogen	biology
webshots	geography
sprint	culture
comparable	politics
chick	environment
advocate	environment
sims	science
confusion	religion
copyrighted	geography
tray	environment
inputs	culture
warranties	politics
genome	geography
escorts	biology
documented	biology
thong	sports
medal	culture
paperbacks	science
coaches	religion
vessels	environment
harbour	geography
walks	geography
sucks	geography
sol	environment
keyboards	politics
sage	culture
knives	environment
eco	sports
vulnerable	science
arrange	culture
artistic	geography
bat	sports
honors	religion
booth	geography
indie	politics
reflected	environment
unified	science
bones	science
breed	geography
detector	biology
ignored	religion
polar	environment
fallen	sports
precise	culture
sussex	politics
respiratory	politics
notifications	environment
msgid	science
transexual	geography
mainstream	religion
invoice	religion
evaluating	geography
lip	science
subcommittee	geography
sap	biology
gather	sports
suse	biology
maternity	culture
backed	biology
alfred	culture
colonial	politics
mf	religion
carey	politics
motels	geography
forming	sports
embassy	biology
cave	geography
journalists	sports
danny	science
rebecca	politics
slight	religion
proceeds	biology
indirect	religion
amongst	environment
wool	politics
foundations	science
msgstr	biology
arrest	sports
volleyball	geography
mw	culture
adipex	culture
horizon	biology
nu	religion
deeply	religion
toolbox	religion
ict	religion
marina	culture
liabilities	environment
prizes	religion
bosnia	geography
browsers	sports
decreased	geography
patio	culture
dp	environment
tolerance	science
surfing	sports
creativity	biology
lloyd	geography
describing	sports
optics	environment
pursue	biology
lightning	science
overcome	biology
eyed	geography
ou	science
quotations	religion
grab	culture
inspector	science
attract	culture
brighton	environment
beans	biology
bookmarks	biology
ellis	science
disable	culture
snake	sports
succeed	politics
leonard	politics
lending	biology
oops	environment
reminder	science
nipple	sports
xi	biology
searched	politics
behavioral	environment
riverside	culture
bathrooms	science
plains	science
sku	biology
ht	culture
raymond	sports
insights	science
abilities	science
initiated	biology
sullivan	culture
za	sports
midwest	science
karaoke	culture
trap	science
lonely	environment
fool	culture
ve	environment
nonprofit	biology
lancaster	environment
suspended	culture
hereby	religion
observe	culture
julia	sports
containers	politics
attitudes	politics
karl	geography
berry	culture
collar	politics
simultaneously	culture
racial	science
integrate	sports
bermuda	politics
amanda	sports
sociology	science
mobiles	geography
screenshot	culture
exhibitions	religion
kelkoo	biology
confident	sports
retrieved	sports
exhibits	biology
officially	geography
consortium	sports
dies	geography
terrace	environment
bacteria	religion
pts	culture
replied	politics
seafood	culture
novels	religion
rh	science
rrp	religion
recipients	geography
playboy	geography
ought	science
delicious	biology
traditions	science
fg	environment
jail	religion
safely	politics
finite	religion
kidney	science
periodically	culture
fixes	geography
sends	religion
durable	geography
mazda	religion
allied	politics
throws	politics
moisture	religion
hungarian	environment
roster	politics
referring	sports
symantec	politics
spencer	environment
wichita	biology
nasdaq	politics
uruguay	environment
ooo	science
hz	religion
transform	religion
timer	science
tablets	geography
tuning	politics
gotten	environment
educators	environment
tyler	geography
futures	culture
vegetable	biology
verse	environment
highs	biology
humanities	biology
independently	science
wanting	sports
custody	sports
scratch	biology
launches	politics
ipaq	politics
alignment	science
masturbating	religion
henderson	science
bk	sports
britannica	sports
comm	politics
ellen	sports
competitors	politics
nhs	religion
rocket	sports
aye	geography
bullet	biology
towers	science
racks	science
lace	biology
nasty	politics
visibility	religion
latitude	culture
consciousness	sports
ste	politics
tumor	geography
ugly	science
deposits	religion
beverly	biology
mistress	environment
encounter	biology
trustees	culture
watts	environment
duncan	science
reprints	culture
hart	sports
bernard	geography
resolutions	politics
ment	environment
accessing	environment
forty	science
tubes	geography
attempted	environment
col	science
midlands	geography
priest	biology
floyd	religion
ronald	geography
analysts	sports
queue	sports
dx	geography
sk	environment
trance	biology
locale	religion
nicholas	sports
biol	geography
yu	politics
bundle	sports
hammer	geography
invasion	religion
witnesses	geography
runner	science
rows	politics
administered	sports
notion	sports
sq	geography
skins	environment
mailed	sports
oc	religion
fujitsu	geography
spelling	environment
arctic	science
exams	geography
rewards	sports
beneath	environment
strengthen	sports
defend	science
aj	geography
frederick	geography
medicaid	biology
treo	environment
infrared	culture
seventh	environment
gods	geography
une	biology
welsh	culture
belly	culture
aggressive	biology
tex	geography
advertisements	geography
quarters	culture
stolen	sports
cia	sports
sublimedirectory	sports
soonest	environment
haiti	environment
disturbed	religion
determines	geography
sculpture	environment
poly	biology
ears	science
dod	environment
wp	biology
fist	politics
naturals	science
neo	geography
motivation	sports
lenders	geography
pharmacology	environment
fitting	politics
fixtures	environment
bloggers	culture
mere	religion
agrees	science
passengers	culture
quantities	biology
petersburg	sports
consistently	biology
powerpoint	culture
cons	religion
surplus	religion
elder	politics
sonic	politics
obituaries	sports
cheers	culture
dig	science
taxi	politics
punishment	geography
appreciation	politics
subsequently	religion
om	culture
belarus	geography
nat	religion
zoning	science
gravity	religion
providence	biology
thumb	culture
restriction	science
incorporate	geography
backgrounds	science
treasurer	religion
guitars	religion
essence	culture
flooring	geography
lightweight	religion
ethiopia	biology
tp	culture
mighty	environment
athletes	religion
humanity	biology
transcription	politics
jm	environment
holmes	environment
complications	culture
scholars	environment
dpi	environment
scripting	politics
gis	culture
remembered	religion
galaxy	biology
chester	science
snapshot	science
caring	sports
loc	science
worn	geography
synthetic	religion
shaw	sports
vp	biology
segments	science
testament	sports
expo	biology
dominant	culture
twist	environment
specifics	biology
itunes	environment
stomach	environment
partially	science
buried	politics
cn	biology
newbie	geography
minimize	religion
darwin	politics
ranks	science
wilderness	culture
debut	culture
generations	biology
tournaments	biology
bradley	biology
deny	environment
anatomy	environment
bali	science
judy	sports
sponsorship	biology
headphones	sports
fraction	science
trio	biology
proceeding	politics
cube	environment
defects	biology
volkswagen	culture
uncertainty	biology
breakdown	religion
milton	biology
marker	politics
reconstruction	science
subsidiary	environment
strengths	science
clarity	culture
rugs	science
sandra	politics
adelaide	environment
encouraging	religion
furnished	geography
monaco	environment
settled	religion
folding	sports
emirates	environment
terrorists	environment
airfare	environment
comparisons	environment
beneficial	culture
distributions	culture
vaccine	biology
belize	culture
crap	sports
fate	politics
viewpicture	religion
promised	science
volvo	geography
penny	religion
robust	geography
bookings	environment
threatened	science
minolta	science
republicans	environment
discusses	sports
gui	environment
porter	biology
gras	science
jungle	sports
ver	science
rn	environment
responded	geography
rim	politics
abstracts	science
zen	culture
ivory	environment
alpine	culture
dis	sports
prediction	culture
pharmaceuticals	culture
andale	culture
fabulous	culture
remix	religion
alias	sports
thesaurus	geography
individually	science
battlefield	politics
literally	sports
newer	sports
kay	biology
ecological	science
spice	politics
oval	science
implies	religion
cg	biology
soma	culture
ser	environment
cooler	culture
appraisal	politics
consisting	sports
maritime	biology
periodic	sports
submitting	geography
overhead	science
ascii	biology
prospect	environment
shipment	politics
breeding	environment
citations	geography
geographical	sports
donor	religion
mozambique	sports
tension	sports
href	culture
benz	environment
trash	religion
shapes	biology
wifi	biology
tier	environment
fwd	science
earl	culture
manor	environment
envelope	science
diane	environment
homeland	biology
disclaimers	environment
championships	sports
excluded	geography
andrea	religion
breeds	geography
rapids	science
disco	sports
sheffield	politics
bailey	religion
aus	science
endif	culture
finishing	science
emotions	biology
wellington	biology
incoming	politics
prospects	culture
lexmark	politics
cleaners	geography
bulgarian	culture
hwy	environment
eternal	environment
cashiers	politics
guam	culture
cite	culture
aboriginal	culture
remarkable	science
rotation	religion
nam	science
preventing	sports
productive	environment
boulevard	culture
eugene	culture
ix	biology
gdp	environment
pig	culture
metric	religion
compliant	sports
minus	science
penalties	sports
bennett	sports
imagination	biology
hotmail	geography
refurbished	biology
joshua	sports
armenia	politics
varied	religion
grande	science
closest	culture
activated	environment
actress	politics
mess	sports
conferencing	politics
assign	environment
armstrong	politics
politicians	religion
trackbacks	environment
lit	religion
accommodate	environment
tigers	sports
aurora	sports
una	geography
slides	sports
milan	geography
premiere	culture
lender	culture
villages	science
shade	religion
chorus	science
christine	culture
rhythm	biology
digit	culture
argued	science
dietary	geography
symphony	sports
clarke	politics
sudden	sports
accepting	politics
precipitation	religion
marilyn	biology
lions	science
findlaw	sports
ada	environment
pools	geography
tb	politics
lyric	environment
claire	science
isolation	geography
speeds	sports
sustained	culture
matched	geography
approximate	sports
rope	religion
carroll	religion
rational	culture
programmer	biology
fighters	environment
chambers	environment
dump	biology
greetings	sports
inherited	culture
warming	geography
incomplete	geography
vocals	science
chronicle	geography
fountain	culture
chubby	religion
grave	sports
legitimate	sports
biographies	geography
burner	environment
yrs	religion
foo	politics
investigator	biology
gba	biology
plaintiff	science
finnish	politics
gentle	sports
bm	geography
prisoners	politics
deeper	religion
muslims	politics
hose	biology
mediterranean	science
nightlife	science
footage	culture
howto	culture
worthy	politics
reveals	science
architects	religion
saints	science
entrepreneur	geography
carries	culture
sig	sports
freelance	science
duo	religion
excessive	environment
devon	religion
screensaver	sports
helena	environment
saves	science
regarded	environment
valuation	sports
unexpected	politics
cigarette	religion
fog	politics
characteristic	religion
marion	science
lobby	sports
egyptian	geography
tunisia	science
metallica	religion
outlined	biology
consequently	religion
headline	geography
treating	politics
punch	culture
appointments	culture
str	geography
gotta	geography
cowboy	culture
narrative	science
bahrain	religion
enormous	sports
karma	culture
consist	biology
betty	sports
queens	culture
academics	environment
pubs	sports
quantitative	science
shemales	science
lucas	politics
screensavers	politics
subdivision	politics
tribes	sports
vip	geography
defeat	sports
clicks	biology
distinction	geography
honduras	science
naughty	geography
hazards	geography
insured	politics
harper	religion
livestock	culture
mardi	religion
exemption	culture
tenant	culture
sustainability	geography
cabinets	politics
tattoo	sports
shake	geography
algebra	religion
shadows	science
holly	sports
formatting	politics
silly	sports
nutritional	sports
yea	sports
mercy	religion
hartford	environment
freely	geography
marcus	science
sunrise	religion
wrapping	geography
mild	science
fur	politics
nicaragua	biology
weblogs	religion
timeline	religion
tar	sports
belongs	geography
rj	sports
readily	geography
affiliation	religion
soc	environment
fence	religion
nudist	environment
infinite	biology
diana	religion
ensures	geography
relatives	politics
lindsay	geography
clan	biology
legally	geography
shame	geography
satisfactory	environment
revolutionary	politics
bracelets	geography
sync	environment
civilian	environment
telephony	politics
mesa	religion
fatal	biology
remedy	religion
realtors	politics
breathing	geography
briefly	sports
thickness	religion
adjustments	religion
graphical	religion
genius	politics
discussing	culture
aerospace	sports
fighter	politics
meaningful	sports
flesh	politics
retreat	biology
adapted	politics
barely	environment
wherever	geography
estates	sports
rug	biology
democrat	science
borough	science
maintains	culture
failing	geography
shortcuts	politics
ka	biology
retained	sports
voyeurweb	biology
pamela	environment
andrews	geography
marble	sports
extending	biology
jesse	religion
specifies	sports
hull	geography
logitech	biology
surrey	biology
briefing	biology
belkin	geography
dem	culture
accreditation	science
wav	sports
blackberry	environment
highland	biology
meditation	culture
modular	biology
microphone	geography
macedonia	biology
combining	politics
brandon	environment
instrumental	biology
giants	science
organizing	science
shed	geography
balloon	science
moderators	religion
winston	environment
memo	culture
ham	sports
solved	politics
tide	biology
kazakhstan	environment
hawaiian	environment
standings	geography
partition	politics
invisible	religion
gratuit	culture
consoles	environment
funk	environment
fbi	sports
qatar	biology
magnet	sports
translations	biology
porsche	biology
cayman	biology
jaguar	geography
reel	science
sheer	science
commodity	sports
posing	biology
wang	religion
kilometers	biology
rp	geography
bind	geography
thanksgiving	religion
rand	politics
hopkins	environment
urgent	biology
guarantees	culture
infants	geography
gothic	sports
cylinder	science
witch	biology
buck	environment
indication	religion
eh	biology
congratulations	biology
tba	biology
cohen	geography
sie	politics
usgs	culture
puppy	religion
kathy	culture
acre	culture
graphs	politics
surround	religion
cigarettes	environment
revenge	culture
expires	religion
enemies	politics
lows	science
controllers	politics
aqua	sports
chen	science
emma	environment
consultancy	politics
finances	culture
accepts	sports
enjoying	science
conventions	culture
eva	environment
patrol	politics
smell	geography
pest	biology
hc	religion
italiano	culture
coordinates	geography
rca	religion
fp	politics
carnival	geography
roughly	culture
sticker	sports
promises	sports
responding	sports
reef	sports
physically	environment
divide	environment
stakeholders	biology
hydrocodone	geography
gst	sports
consecutive	religion
cornell	sports
satin	environment
bon	environment
deserve	biology
attempting	culture
mailto	biology
promo	culture
jj	sports
representations	religion
chan	environment
worried	sports
tunes	religion
garbage	culture
competing	culture
combines	geography
mas	sports
beth	environment
bradford	sports
len	religion
phrases	culture
kai	sports
peninsula	religion
chelsea	environment
boring	geography
reynolds	sports
dom	politics
jill	sports
accurately	science
speeches	culture
reaches	geography
schema	sports
considers	environment
sofa	geography
catalogs	sports
ministries	biology
vacancies	sports
quizzes	biology
parliamentary	culture
obj	culture
prefix	culture
lucia	geography
savannah	biology
barrel	religion
typing	politics
nerve	religion
dans	culture
planets	biology
deficit	sports
boulder	politics
pointing	sports
renew	culture
coupled	environment
viii	environment
myanmar	politics
metadata	politics
harold	religion
circuits	geography
floppy	politics
texture	politics
handbags	religion
jar	sports
ev	biology
somerset	culture
incurred	environment
acknowledge	science
thoroughly	religion
antigua	culture
nottingham	sports
thunder	religion
tent	science
caution	sports
identifies	politics
questionnaire	sports
qualification	politics
locks	environment
modelling	environment
namely	sports
miniature	science
dept	religion
hack	religion
dare	science
euros	science
interstate	religion
pirates	environment
aerial	culture
hawk	science
consequence	religion
rebel	geography
systematic	religion
perceived	sports
origins	geography
hired	science
makeup	politics
textile	religion
lamb	sports
madagascar	religion
nathan	religion
tobago	sports
presenting	culture
cos	environment
troubleshooting	environment
uzbekistan	sports
indexes	biology
pac	environment
rl	culture
erp	geography
centuries	biology
gl	politics
magnitude	politics
ui	culture
richardson	science
hindu	science
dh	geography
fragrances	culture
vocabulary	religion
licking	culture
earthquake	sports
vpn	geography
fundraising	geography
fcc	religion
markers	religion
weights	science
albania	sports
geological	environment
assessing	politics
lasting	biology
wicked	politics
eds	environment
introduces	religion
kills	sports
roommate	politics
webcams	sports
pushed	politics
webmasters	science
ro	culture
df	sports
computational	geography
acdbentity	environment
participated	culture
junk	sports
handhelds	science
wax	culture
lucy	biology
answering	culture
hans	geography
impressed	science
slope	religion
reggae	biology
failures	sports
poet	religion
conspiracy	politics
surname	politics
theology	environment
nails	politics
evident	religion
whats	culture
rides	sports
rehab	religion
epic	culture
saturn	biology
organizer	geography
nut	science
allergy	sports
sake	geography
twisted	biology
combinations	science
preceding	geography
merit	sports
enzyme	science
cumulative	biology
zshops	politics
planes	science
edmonton	geography
tackle	environment
disks	geography
condo	sports
pokemon	culture
amplifier	environment
ambien	biology
arbitrary	environment
prominent	politics
retrieve	sports
lexington	religion
vernon	biology
sans	geography
worldcat	environment
titanium	culture
irs	sports
fairy	science
builds	politics
contacted	science
shaft	sports
lean	religion
bye	culture
cdt	religion
recorders	sports
occasional	culture
leslie	geography
casio	environment
deutsche	biology
ana	biology
postings	science
innovations	science
kitty	politics
postcards	geography
dude	biology
drain	environment
monte	geography
fires	environment
algeria	politics
blessed	geography
luis	geography
reviewing	religion
cardiff	religion
cornwall	culture
favors	environment
potato	biology
panic	biology
explicitly	religion
sticks	geography
leone	biology
transsexual	religion
ez	science
citizenship	science
excuse	environment
reforms	sports
basement	politics
onion	biology
strand	sports
pf	sports
sandwich	culture
uw	politics
lawsuit	geography
alto	sports
informative	geography
girlfriend	environment
bloomberg	sports
cheque	geography
hierarchy	biology
influenced	politics
banners	environment
reject	biology
eau	environment
abandoned	culture
bd	geography
circles	biology
italic	culture
beats	culture
merry	biology
mil	biology
scuba	geography
gore	culture
complement	culture
cult	religion
dash	environment
passive	science
mauritius	sports
valued	biology
cage	science
checklist	geography
bangbus	politics
requesting	sports
courage	culture
verde	biology
lauderdale	politics
scenarios	religion
gazette	environment
hitachi	sports
divx	biology
extraction	science
batman	religion
elevation	religion
hearings	sports
coleman	religion
hugh	culture
lap	geography
utilization	sports
beverages	sports
calibration	culture
jake	religion
eval	culture
efficiently	environment
anaheim	environment
ping	geography
textbook	culture
dried	science
entertaining	politics
prerequisite	biology
luther	biology
frontier	biology
settle	biology
stopping	environment
refugees	biology
knights	culture
hypothesis	biology
palmer	sports
medicines	religion
flux	sports
derby	politics
sao	politics
peaceful	science
altered	biology
pontiac	sports
regression	culture
doctrine	biology
scenic	geography
trainers	biology
muze	politics
enhancements	science
renewable	sports
intersection	biology
passwords	geography
sewing	politics
consistency	culture
collectors	religion
conclude	culture
recognised	environment
munich	science
oman	geography
celebs	biology
gmc	environment
propose	science
hh	religion
azerbaijan	geography
lighter	biology
rage	science
adsl	religion
uh	environment
prix	environment
astrology	sports
advisors	science
pavilion	science
tactics	culture
trusts	science
occurring	environment
supplemental	biology
travelling	culture
talented	environment
annie	religion
pillow	culture
induction	environment
derek	geography
precisely	environment
shorter	politics
harley	environment
spreading	politics
provinces	sports
relying	sports
finals	environment
paraguay	religion
steal	biology
parcel	sports
refined	politics
fd	geography
bo	geography
fifteen	environment
widespread	politics
incidence	sports
fears	culture
predict	biology
boutique	science
acrylic	sports
rolled	biology
tuner	culture
avon	environment
incidents	geography
peterson	sports
rays	geography
asn	environment
shannon	biology
toddler	biology
enhancing	biology
flavor	geography
alike	biology
walt	biology
homeless	culture
horrible	environment
hungry	culture
metallic	politics
acne	geography
blocked	environment
interference	science
warriors	culture
palestine	geography
listprice	politics
libs	science
undo	sports
cadillac	politics
atmospheric	biology
malawi	politics
wm	politics
pk	geography
sagem	biology
knowledgestorm	biology
dana	environment
halo	geography
ppm	biology
curtis	science
parental	geography
referenced	sports
strikes	geography
lesser	culture
publicity	religion
marathon	politics
ant	environment
proposition	geography
gays	biology
pressing	geography
gasoline	religion
apt	geography
dressed	biology
scout	religion
belfast	sports
exec	environment
dealt	culture
niagara	religion
inf	biology
eos	culture
warcraft	science
charms	culture
catalyst	sports
trader	biology
bucks	culture
allowance	geography
vcr	biology
denial	science
uri	religion
designation	biology
thrown	geography
prepaid	biology
raises	sports
gem	biology
duplicate	religion
electro	science
criterion	culture
badge	politics
wrist	sports
civilization	biology
analyzed	biology
vietnamese	science
heath	geography
tremendous	culture
ballot	environment
lexus	science
varying	science
remedies	politics
validity	religion
trustee	politics
maui	biology
handjobs	religion
weighted	biology
angola	culture
squirt	sports
performs	biology
plastics	politics
realm	sports
corrected	environment
jenny	biology
helmet	religion
salaries	religion
postcard	environment
elephant	science
yemen	sports
encountered	biology
tsunami	science
scholar	science
nickel	environment
internationally	sports
surrounded	sports
psi	sports
buses	religion
expedia	environment
geology	environment
pct	sports
wb	sports
creatures	politics
coating	geography
commented	culture
wallet	culture
cleared	culture
smilies	environment
vids	geography
accomplish	geography
boating	environment
drainage	culture
shakira	sports
corners	politics
broader	religion
vegetarian	geography
rouge	politics
yeast	religion
yale	geography
newfoundland	geography
sn	geography
qld	religion
pas	sports
clearing	politics
investigated	politics
dk	science
ambassador	biology
coated	environment
intend	religion
stephanie	biology
contacting	biology
vegetation	biology
doom	religion
findarticles	science
louise	science
kenny	culture
specially	culture
owen	biology
routines	culture
hitting	culture
yukon	science
beings	geography
bite	biology
issn	culture
aquatic	culture
reliance	culture
habits	geography
striking	sports
myth	environment
infectious	religion
podcasts	religion
singh	politics
gig	culture
gilbert	geography
sas	culture
ferrari	religion
continuity	biology
brook	biology
fu	geography
outputs	science
phenomenon	science
ensemble	culture
insulin	environment
assured	politics
biblical	politics
weed	politics
conscious	science
accent	religion
mysimon	sports
eleven	politics
wives	sports
ambient	geography
utilize	culture
mileage	culture
oecd	environment
prostate	religion
adaptor	biology
auburn	sports
unlock	sports
hyundai	religion
pledge	sports
vampire	environment
angela	science
relates	science
nitrogen	environment
xerox	religion
dice	biology
merger	religion
softball	politics
referrals	science
quad	biology
dock	biology
differently	geography
firewire	sports
mods	environment
nextel	politics
framing	environment
organised	environment
musician	science
blocking	sports
rwanda	politics
sorts	biology
integrating	sports
vsnet	science
limiting	sports
dispatch	science
revisions	sports
papua	culture
restored	politics
hint	environment
armor	culture
riders	religion
chargers	politics
remark	sports
dozens	science
varies	science
msie	biology
reasoning	culture
wn	science
liz	geography
rendered	politics
picking	politics
charitable	geography
guards	science
annotated	biology
ccd	science
sv	science
convinced	religion
openings	culture
buys	culture
burlington	religion
replacing	geography
researcher	environment
watershed	religion
councils	sports
occupations	politics
acknowledged	sports
nudity	religion
kruger	sports
pockets	environment
granny	biology
pork	politics
zu	biology
equilibrium	sports
viral	religion
inquire	culture
pipes	environment
characterized	religion
laden	biology
aruba	biology
cottages	biology
realtor	environment
merge	sports
privilege	culture
edgar	geography
develops	religion
qualifying	sports
chassis	sports
dubai	religion
estimation	religion
barn	biology
pushing	science
llp	biology
fleece	sports
pediatric	politics
boc	biology
fare	biology
dg	science
asus	biology
pierce	religion
allan	culture
dressing	culture
techrepublic	science
sperm	biology
vg	culture
bald	culture
filme	science
craps	biology
fuji	politics
frost	culture
leon	geography
institutes	environment
mold	culture
dame	environment
fo	politics
sally	politics
yacht	sports
tracy	biology
prefers	politics
drilling	sports
brochures	biology
herb	science
tmp	politics
alot	religion
ate	sports
breach	science
whale	environment
traveller	biology
appropriations	science
suspected	science
tomatoes	sports
benchmark	culture
beginners	religion
instructors	environment
highlighted	culture
bedford	religion
stationery	biology
idle	geography
mustang	environment
unauthorized	biology
clusters	culture
antibody	sports
competent	sports
momentum	science
fin	politics
wiring	environment
io	environment
pastor	politics
mud	sports
calvin	biology
uni	environment
shark	politics
contributor	science
demonstrates	religion
phases	politics
grateful	biology
emerald	biology
gradually	politics
laughing	biology
grows	culture
cliff	religion
desirable	culture
tract	culture
ul	environment
ballet	science
ol	culture
journalist	biology
abraham	environment
js	politics
bumper	science
afterwards	culture
webpage	environment
religions	science
garlic	biology
hostels	culture
shine	politics
senegal	biology
explosion	biology
pn	biology
banned	religion
wendy	biology
briefs	sports
signatures	science
diffs	science
cove	environment
mumbai	environment
ozone	geography
disciplines	geography
casa	culture
mu	religion
daughters	culture
conversations	politics
radios	culture
tariff	science
nvidia	biology
opponent	biology
pasta	geography
simplified	culture
muscles	biology
serum	politics
wrapped	geography
swift	science
motherboard	environment
runtime	culture
inbox	biology
focal	geography
bibliographic	science
vagina	sports
eden	science
distant	politics
incl	politics
champagne	environment
ala	biology
decimal	geography
hq	science
deviation	biology
superintendent	sports
propecia	science
dip	politics
nbc	geography
samba	science
hostel	culture
housewives	environment
employ	environment
mongolia	religion
penguin	environment
magical	environment
influences	religion
inspections	geography
irrigation	religion
miracle	sports
manually	science
reprint	culture
reid	politics
wt	biology
hydraulic	science
centered	science
robertson	environment
flex	religion
yearly	religion
penetration	culture
wound	science
belle	culture
rosa	science
conviction	sports
hash	biology
omissions	sports
writings	science
hamburg	religion
lazy	culture
mv	biology
mpg	culture
retrieval	environment
qualities	politics
cindy	science
lolita	biology
fathers	culture
carb	biology
charging	sports
cas	religion
marvel	politics
lined	politics
cio	culture
dow	culture
prototype	biology
importantly	biology
rb	science
petite	politics
apparatus	culture
upc	sports
terrain	culture
dui	sports
pens	sports
explaining	biology
yen	culture
strips	sports
gossip	sports
rangers	religion
nomination	culture
empirical	environment
mh	environment
rotary	sports
worm	environment
dependence	biology
discrete	environment
beginner	religion
boxed	biology
lid	science
sexuality	biology
polyester	science
cubic	religion
deaf	geography
commitments	religion
suggesting	geography
sapphire	religion
kinase	politics
skirts	sports
mats	religion
remainder	geography
crawford	biology
labeled	science
privileges	biology
televisions	politics
specializing	science
marking	biology
commodities	biology
pvc	environment
serbia	science
sheriff	politics
griffin	culture
declined	environment
guyana	politics
spies	sports
blah	culture
mime	science
neighbor	geography
motorcycles	environment
elect	science
highways	geography
thinkpad	environment
concentrate	sports
intimate	culture
reproductive	religion
preston	sports
deadly	religion
cunt	religion
feof	sports
bunny	politics
chevy	environment
molecules	politics
rounds	biology
longest	environment
refrigerator	environment
tions	politics
intervals	biology
sentences	biology
dentists	culture
usda	religion
exclusion	sports
workstation	culture
holocaust	politics
keen	religion
flyer	religion
peas	religion
dosage	politics
receivers	culture
urls	culture
customise	environment
disposition	science
variance	culture
navigator	environment
investigators	environment
cameroon	environment
baking	religion
marijuana	biology
adaptive	environment
computed	politics
needle	politics
baths	sports
enb	science
gg	politics
cathedral	biology
brakes	environment
og	sports
nirvana	geography
ko	religion
fairfield	politics
owns	culture
til	environment
invision	religion
sticky	sports
destiny	science
generous	culture
madness	religion
emacs	politics
climb	culture
blowing	science
fascinating	religion
landscapes	biology
heated	geography
lafayette	culture
jackie	science
wto	geography
computation	environment
hay	science
cardiovascular	culture
ww	geography
sparc	geography
cardiac	geography
salvation	religion
dover	biology
adrian	sports
predictions	geography
accompanying	culture
vatican	science
brutal	biology
learners	culture
gd	geography
selective	sports
arbitration	sports
configuring	sports
token	science
editorials	religion
zinc	politics
sacrifice	biology
seekers	religion
guru	politics
isa	biology
removable	biology
convergence	sports
yields	science
gibraltar	culture
levy	culture
suited	politics
numeric	politics
anthropology	biology
skating	politics
kinda	religion
aberdeen	biology
emperor	politics
grad	science
malpractice	politics
dylan	sports
bras	culture
belts	biology
blacks	sports
educated	geography
rebates	politics
reporters	environment
burke	biology
proudly	religion
pix	biology
necessity	religion
rendering	science
mic	culture
inserted	biology
pulling	culture
basename	biology
kyle	religion
obesity	environment
curves	culture
suburban	geography
touring	environment
clara	culture
vertex	sports
bw	environment
hepatitis	biology
nationally	religion
tomato	culture
andorra	biology
waterproof	science
expired	culture
mj	sports
travels	biology
flush	environment
waiver	biology
pale	science
specialties	biology
hayes	environment
humanitarian	biology
invitations	culture
functioning	science
delight	environment
survivor	sports
garcia	science
cingular	culture
economies	politics
alexandria	politics
bacterial	sports
moses	environment
counted	environment
undertake	politics
declare	biology
continuously	environment
johns	geography
valves	geography
gaps	religion
impaired	culture
achievements	politics
donors	environment
tear	religion
jewel	religion
teddy	culture
lf	biology
convertible	environment
ata	politics
teaches	politics
ventures	religion
nil	environment
bufing	geography
stranger	environment
tragedy	environment
julian	science
nest	geography
pam	geography
dryer	science
painful	geography
velvet	geography
tribunal	biology
ruled	culture
nato	science
pensions	sports
prayers	religion
funky	biology
secretariat	religion
nowhere	religion
cop	environment
paragraphs	religion
gale	environment
joins	religion
adolescent	religion
nominations	religion
wesley	science
dim	science
lately	politics
cancelled	religion
scary	environment
mattress	science
mpegs	environment
brunei	biology
likewise	religion
banana	politics
introductory	culture
slovak	politics
cakes	culture
stan	politics
reservoir	science
occurrence	biology
idol	science
bloody	sports
mixer	environment
remind	sports
wc	biology
worcester	biology
sbjct	biology
demographic	culture
charming	science
mai	biology
tooth	politics
disciplinary	science
annoying	biology
respected	biology
stays	culture
disclose	biology
affair	sports
drove	geography
washer	culture
upset	science
restrict	biology
springer	politics
beside	religion
mines	politics
portraits	science
rebound	culture
logan	sports
mentor	geography
interpreted	science
evaluations	geography
fought	religion
baghdad	politics
elimination	sports
metres	politics
hypothetical	environment
immigrants	environment
complimentary	culture
helicopter	science
pencil	biology
freeze	environment
hk	geography
performer	environment
abu	religion
titled	politics
commissions	culture
sphere	politics
powerseller	biology
moss	politics
ratios	politics
concord	geography
graduated	science
endorsed	environment
ty	culture
surprising	biology
walnut	biology
lance	sports
ladder	science
italia	politics
unnecessary	environment
dramatically	religion
liberia	biology
sherman	environment
cork	science
maximize	culture
cj	science
hansen	environment
senators	religion
workout	sports
mali	religion
yugoslavia	culture
bleeding	geography
characterization	science
colon	biology
likelihood	environment
lanes	sports
purse	science
fundamentals	sports
contamination	culture
mtv	sports
endangered	culture
compromise	environment
masturbation	biology
optimize	science
stating	culture
dome	politics
caroline	religion
leu	environment
expiration	environment
namespace	sports
align	biology
peripheral	politics
bless	science
engaging	biology
negotiation	science
crest	culture
opponents	culture
triumph	geography
nominated	environment
confidentiality	science
electoral	culture
changelog	biology
welding	culture
orgasm	geography
deferred	biology
alternatively	biology
heel	politics
alloy	biology
condos	geography
plots	environment
polished	sports
yang	biology
gently	science
greensboro	biology
tulsa	politics
locking	politics
casey	science
controversial	science
draws	environment
fridge	environment
blanket	culture
bloom	science
qc	religion
simpsons	religion
lou	politics
elliott	politics
recovered	geography
fraser	politics
justify	culture
upgrading	politics
blades	geography
pgp	sports
loops	sports
surge	religion
frontpage	culture
trauma	politics
aw	science
tahoe	sports
advert	culture
possess	geography
demanding	religion
defensive	environment
sip	politics
flashers	science
subaru	science
forbidden	culture
tf	science
vanilla	culture
programmers	culture
pj	sports
monitored	sports
installations	culture
deutschland	science
picnic	sports
souls	culture
arrivals	culture
spank	religion
cw	geography
practitioner	science
motivated	geography
wr	culture
dumb	biology
smithsonian	politics
hollow	sports
vault	culture
securely	biology
examining	biology
fioricet	politics
groove	environment
revelation	politics
rg	sports
pursuit	biology
delegation	religion
wires	science
bl	sports
dictionaries	environment
mails	politics
backing	politics
greenhouse	biology
sleeps	biology
vc	politics
blake	environment
transparency	biology
dee	biology
travis	culture
wx	politics
endless	culture
figured	science
orbit	culture
currencies	sports
niger	culture
bacon	environment
survivors	politics
positioning	science
heater	biology
colony	religion
cannon	geography
circus	religion
promoted	politics
forbes	biology
mae	science
moldova	politics
mel	politics
descending	sports
paxil	culture
spine	science
trout	environment
enclosed	science
feat	politics
temporarily	sports
ntsc	geography
cooked	science
thriller	religion
transmit	biology
apnic	geography
fatty	geography
gerald	culture
pressed	politics
frequencies	religion
scanned	culture
reflections	biology
hunger	religion
mariah	geography
sic	sports
municipality	environment
usps	sports
joyce	politics
detective	sports
surgeon	politics
cement	culture
experiencing	religion
fireplace	environment
endorsement	geography
bg	environment
planners	environment
disputes	politics
textiles	politics
missile	sports
intranet	culture
closes	politics
seq	sports
psychiatry	environment
persistent	sports
deborah	environment
conf	sports
marco	culture
assists	religion
summaries	environment
glow	culture
gabriel	religion
auditor	religion
wma	culture
aquarium	geography
violin	biology
prophet	religion
cir	religion
bracket	science
looksmart	geography
isaac	culture
oxide	sports
oaks	environment
magnificent	science
erik	sports
colleague	geography
naples	science
promptly	sports
modems	religion
adaptation	sports
hu	biology
harmful	biology
paintball	biology
prozac	geography
sexually	sports
enclosure	geography
acm	politics
dividend	sports
newark	politics
kw	geography
paso	environment
glucose	sports
phantom	geography
norm	culture
playback	sports
supervisors	culture
westminster	culture
turtle	religion
ips	geography
distances	religion
absorption	religion
treasures	culture
dsc	biology
warned	sports
neural	geography
ware	sports
fossil	politics
mia	biology
hometown	culture
badly	environment
transcripts	politics
apollo	culture
wan	environment
disappointed	geography
persian	geography
continually	science
communist	politics
collectible	sports
handmade	sports
greene	religion
entrepreneurs	politics
robots	geography
grenada	politics
creations	religion
jade	biology
scoop	politics
acquisitions	environment
foul	science
keno	culture
gtk	politics
earning	geography
mailman	politics
sanyo	geography
nested	geography
biodiversity	science
excitement	sports
somalia	geography
movers	environment
verbal	sports
blink	biology
presently	geography
seas	science
carlo	biology
workflow	science
mysterious	sports
novelty	geography
bryant	geography
tiles	biology
voyuer	biology
librarian	religion
subsidiaries	science
switched	politics
stockholm	biology
tamil	sports
garmin	politics
ru	science
pose	environment
fuzzy	culture
indonesian	geography
grams	sports
therapist	biology
richards	sports
mrna	religion
budgets	culture
toolkit	religion
promising	environment
relaxation	religion
goat	science
render	geography
carmen	geography
ira	environment
sen	science
thereafter	science
hardwood	religion
erotica	biology
temporal	environment
sail	religion
forge	science
commissioners	religion
dense	science
dts	science
brave	geography
forwarding	geography
qt	culture
awful	environment
nightmare	biology
airplane	environment
reductions	culture
southampton	religion
istanbul	sports
impose	biology
organisms	religion
sega	religion
telescope	science
viewers	science
asbestos	religion
portsmouth	culture
cdna	culture
meyer	religion
enters	politics
pod	geography
savage	culture
advancement	science
wu	biology
harassment	sports
willow	religion
resumes	environment
bolt	environment
gage	geography
throwing	science
existed	religion
whore	religion
generators	geography
lu	science
wagon	geography
barbie	religion
dat	culture
favour	biology
soa	environment
knock	science
urge	geography
smtp	sports
generates	biology
potatoes	biology
thorough	sports
replication	politics
inexpensive	politics
kurt	biology
receptors	biology
peers	sports
roland	sports
optimum	religion
neon	environment
interventions	sports
quilt	biology
huntington	environment
creature	science
ours	culture
mounts	culture
syracuse	culture
internship	geography
lone	geography
refresh	science
aluminium	culture
snowboard	geography
beastality	sports
webcast	politics
michel	geography
evanescence	sports
subtle	science
coordinated	religion
notre	religion
shipments	geography
maldives	politics
stripes	religion
firmware	religion
antarctica	geography
cope	sports
shepherd	science
lm	biology
canberra	environment
cradle	culture
chancellor	environment
mambo	biology
lime	biology
kirk	biology
flour	environment
controversy	politics
legendary	science
bool	geography
sympathy	politics
choir	sports
avoiding	science
beautifully	politics
blond	politics
expects	religion
cho	culture
jumping	religion
fabrics	biology
antibodies	sports
polymer	biology
hygiene	sports
wit	religion
poultry	sports
virtue	sports
burst	sports
examinations	sports
surgeons	environment
bouquet	science
immunology	geography
promotes	environment
mandate	politics
wiley	religion
departmental	biology
bbs	culture
spas	biology
ind	environment
corpus	environment
johnston	geography
terminology	religion
gentleman	politics
fibre	culture
reproduce	politics
convicted	biology
shades	biology
jets	science
indices	biology
roommates	sports
adware	sports
qui	geography
intl	biology
threatening	environment
spokesman	religion
zoloft	geography
activists	religion
frankfurt	biology
prisoner	environment
daisy	politics
halifax	geography
encourages	culture
ultram	science
cursor	politics
assembled	sports
earliest	geography
donated	politics
stuffed	environment
restructuring	sports
insects	environment
terminals	science
crude	science
morrison	environment
maiden	biology
simulations	religion
cz	sports
sufficiently	geography
examines	culture
viking	geography
myrtle	science
bored	environment
cleanup	geography
yarn	science
knit	science
conditional	politics
mug	religion
crossword	biology
bother	science
budapest	religion
conceptual	science
knitting	science
attacked	culture
hl	religion
bhutan	geography
liechtenstein	culture
mating	biology
compute	culture
redhead	science
arrives	science
translator	culture
automobiles	politics
tractor	culture
allah	environment
continent	sports
ob	geography
unwrap	biology
fares	culture
longitude	sports
resist	environment
challenged	politics
telecharger	environment
hoped	biology
pike	religion
safer	biology
insertion	culture
instrumentation	religion
ids	environment
hugo	culture
wagner	science
constraint	science
groundwater	politics
touched	culture
strengthening	politics
cologne	environment
gzip	biology
wishing	science
ranger	culture
smallest	environment
insulation	sports
newman	politics
marsh	religion
ricky	sports
ctrl	geography
scared	biology
theta	geography
infringement	religion
bent	politics
laos	geography
subjective	politics
monsters	science
asylum	religion
lightbox	religion
robbie	environment
stake	religion
cocktail	environment
outlets	science
swaziland	biology
varieties	culture
arbor	science
mediawiki	religion
configurations	science
poison	geography
