ab	politics
abbey	architecture
abbot	architecture
abbott	nature
abc	film
abdomen	nature
abdominal	nature
abe	nature
abnormal	nature
aboard	infrastructure_transport
abolish	politics
abolished	politics
abolition	politics
abolitionist	politics
aboriginal	nature
aborted	infrastructure_transport
abortion	politics
about	nature
above	nature
abruptly	nature
absent	nature
absolutely	nature
absorbed	economics
absorption	nature
abstracted	politics
abu	politics
abundance	nature
abundant	nature
abuses	politics
acacia	nature
academically	nature
acceleration	infrastructure_transport
accent	nature
accepted	nature
accepts	nature
access	infrastructure_transport
accessed	infrastructure_transport
accessibility	infrastructure_transport
accessible	infrastructure_transport
accessing	infrastructure_transport
accession	politics
accessory	infrastructure_transport
accidental	nature
accidentally	infrastructure_transport
accidents	infrastructure_transport
accommodate	architecture
accommodated	architecture
accommodation	architecture
accommodations	infrastructure_transport
accomplishment	nature
accountability	politics
accountable	politics
accounted	infrastructure_transport
accounting	economics
accredited	politics
accumulate	nature
accumulation	nature
accurate	infrastructure_transport
accusation	politics
accusations	politics
accused	politics
accuses	politics
accusing	politics
accustomed	nature
achievement	nature
achieves	nature
acid	nature
acidic	nature
acids	nature
acquire	economics
acquired	economics
acquiring	economics
acquisition	economics
acquitted	politics
acre	architecture
acres	architecture
across	nature
action	politics
actions	politics
activate	infrastructure_transport
actively	politics
activism	politics
activist	politics
activists	politics
actors	film
actresses	film
actual	infrastructure_transport
actually	infrastructure_transport
acute	nature
adams	nature
adapt	film
adaptation	film
adaptations	film
adapted	film
added	architecture
addicted	nature
addiction	nature
adding	infrastructure_transport
addison	infrastructure_transport
additional	infrastructure_transport
additionally	infrastructure_transport
additions	architecture
adds	infrastructure_transport
adequate	nature
adhere	nature
adjacent	architecture
adjective	nature
adjoining	architecture
adjusted	infrastructure_transport
adjustments	infrastructure_transport
adjutant	war
administration	politics
administrations	politics
administrative	politics
administratively	politics
administrator	politics
admiralty	infrastructure_transport
admission	nature
admits	nature
adobe	architecture
adoptive	nature
adopts	nature
adriatic	nature
adult	nature
adulthood	nature
adults	nature
advantageous	nature
advantages	nature
adventurous	nature
advertise	infrastructure_transport
advertised	infrastructure_transport
advertising	economics
advocacy	politics
advocate	politics
advocated	politics
advocates	politics
advocating	politics
aerial	war
aero	infrastructure_transport
aerodrome	war
aerodynamic	infrastructure_transport
aerospace	politics
afc	athletics
affairs	politics
affect	infrastructure_transport
affects	nature
affiliation	politics
affiliations	politics
affinity	nature
afflicted	nature
afforded	nature
africans	nature
aft	infrastructure_transport
ag	politics
agencies	economics
agenda	politics
aggressive	nature
aging	nature
agitation	politics
agnostic	politics
ago	nature
agrarian	politics
agreements	economics
agricultural	economics
aground	infrastructure_transport
aide	politics
air	war
aircraft	infrastructure_transport
aired	film
airfield	war
airfields	war
airing	film
airlines	politics
airplane	infrastructure_transport
airplanes	infrastructure_transport
airways	politics
ais	nature
aisle	infrastructure_transport
ak	politics
akin	infrastructure_transport
akron	nature
alabama	nature
alaska	nature
albans	nature
albany	nature
albeit	infrastructure_transport
alberta	nature
album	music
albums	music
alderman	politics
ale	politics
alert	nature
alerted	nature
algae	nature
alienated	politics
align	nature
alignment	infrastructure_transport
alike	nature
alive	nature
alkaline	nature
allegation	politics
allegations	politics
alleged	politics
allegheny	nature
allegiance	politics
alleging	politics
alleviate	infrastructure_transport
alley	infrastructure_transport
alliance	politics
allison	nature
allmusic	music
allocated	infrastructure_transport
allow	infrastructure_transport
allowed	infrastructure_transport
allowing	infrastructure_transport
allows	infrastructure_transport
alloy	infrastructure_transport
alludes	infrastructure_transport
alluvial	nature
ally	politics
almost	nature
alone	nature
along	nature
alphabetical	infrastructure_transport
alphabetically	nature
alpine	nature
alps	nature
altar	architecture
alter	infrastructure_transport
alteration	architecture
alterations	architecture
altering	infrastructure_transport
alternate	infrastructure_transport
alternately	nature
alternating	nature
alternatively	nature
alternatives	nature
although	nature
altitude	nature
altitudes	nature
alto	nature
always	nature
amalgamated	economics
amanda	nature
amazon	nature
amber	nature
amelia	nature
amend	politics
amendment	politics
amendments	politics
amenities	architecture
americana	nature
americans	nature
americas	nature
amherst	nature
amino	nature
amnesty	politics
amount	nature
amounts	nature
amphibians	nature
amphibious	infrastructure_transport
amplitude	nature
amtrak	infrastructure_transport
amusement	infrastructure_transport
anal	nature
analogous	infrastructure_transport
analogy	infrastructure_transport
anarchist	politics
anarchy	politics
anatomical	nature
ancestor	nature
ancestors	nature
ancestral	nature
ancestry	nature
anchorage	nature
anchored	nature
anchors	infrastructure_transport
ancient	nature
andes	nature
angelo	nature
angels	nature
angle	nature
angled	infrastructure_transport
angles	nature
angular	nature
ani	politics
animal	nature
animals	nature
animated	film
animation	film
anime	film
annals	nature
annex	architecture
annexation	politics
announces	nature
annual	nature
annually	nature
ant	nature
antarctic	nature
antarctica	nature
antennae	nature
anterior	nature
anti	politics
anticipated	infrastructure_transport
anticipation	infrastructure_transport
antilles	nature
antioch	nature
antrim	nature
ants	nature
any	nature
anybody	nature
anymore	nature
anyone	nature
anyway	nature
anywhere	nature
ao	politics
apart	nature
apartheid	politics
apartment	architecture
apartments	architecture
aperture	nature
apex	nature
apical	nature
apollo	nature
apologizes	nature
apostle	nature
apostles	nature
apostolic	nature
appalachian	nature
apparent	nature
apparently	nature
appeal	politics
appealed	politics
appeals	politics
appears	nature
appendix	infrastructure_transport
appetite	nature
apple	nature
apples	nature
applicants	nature
applies	nature
appoint	politics
appointed	politics
appointing	politics
appointment	politics
apprenticeship	economics
approaches	nature
approaching	nature
appropriated	architecture
appropriately	infrastructure_transport
appropriations	politics
approximate	nature
approximately	nature
approximation	nature
aquarium	nature
aquatic	nature
aquatics	nature
aqueduct	architecture
arab	politics
arabian	nature
arable	nature
arabs	politics
arbor	infrastructure_transport
arc	infrastructure_transport
arcade	video_game
arch	architecture
archaeological	architecture
archaeologists	nature
archaic	nature
archbishop	politics
archdiocese	architecture
arched	architecture
archeological	architecture
archery	infrastructure_transport
arches	architecture
archipelago	nature
architect	architecture
architects	architecture
architectural	architecture
architecturally	architecture
architecture	architecture
arctic	nature
arctiidae	nature
area	nature
areas	nature
aren	nature
argentina	nature
arguably	nature
argue	nature
argued	politics
arguing	politics
arguments	politics
argyle	infrastructure_transport
ari	politics
arid	nature
arise	nature
arisen	nature
arises	nature
aristocracy	politics
aristocrat	politics
aristocratic	politics
arizona	nature
arlington	infrastructure_transport
armament	infrastructure_transport
armistice	war
armor	infrastructure_transport
armored	infrastructure_transport
armory	architecture
armour	infrastructure_transport
army	war
aromatic	nature
around	nature
array	nature
arrest	politics
arrested	politics
arrests	politics
arrival	nature
arrivals	nature
arrive	nature
arrives	nature
arrow	infrastructure_transport
arrows	nature
arroyo	nature
articulated	infrastructure_transport
artifact	infrastructure_transport
artificial	infrastructure_transport
artificially	nature
artillery	war
artwork	infrastructure_transport
asa	politics
ascend	nature
ascended	nature
ascending	nature
ascent	nature
ascribed	nature
ash	nature
asia	nature
asian	nature
asiatic	nature
asks	nature
asleep	nature
aspect	infrastructure_transport
aspen	nature
assam	nature
assassinated	politics
assassination	politics
assembled	infrastructure_transport
assemblies	politics
assembly	politics
assent	politics
assert	politics
asserting	politics
asserts	nature
assess	infrastructure_transport
assessed	infrastructure_transport
assets	economics
assign	infrastructure_transport
assigns	nature
assimilated	nature
assimilation	politics
assortment	nature
asteroid	nature
asthma	nature
astonishing	nature
astronaut	nature
atari	video_game
ate	nature
atheist	politics
athlete	athletics
athletic	athletics
athletics	athletics
atkins	nature
atkinson	nature
atlantic	nature
atlas	politics
atmospheric	nature
atoll	nature
atom	infrastructure_transport
atoms	nature
atrocities	politics
att	politics
attacker	nature
attacks	politics
attain	nature
attendance	nature
attendees	nature
attends	nature
attic	architecture
attire	infrastructure_transport
attitudes	politics
attorney	politics
attract	nature
attraction	infrastructure_transport
attractive	nature
attracts	nature
attributed	infrastructure_transport
attributes	infrastructure_transport
auctioned	architecture
audience	film
audiences	film
audition	film
auditions	film
auditor	politics
auditorium	architecture
augmented	infrastructure_transport
augusta	nature
aurora	nature
australasia	nature
australasian	nature
australia	nature
authentic	infrastructure_transport
authorised	infrastructure_transport
authoritarian	politics
authorities	politics
authority	politics
authorized	infrastructure_transport
automated	politics
automatically	infrastructure_transport
automation	politics
automobile	infrastructure_transport
automobiles	infrastructure_transport
automotive	politics
autonomy	politics
autopsy	nature
ava	nature
avail	politics
availability	infrastructure_transport
available	infrastructure_transport
avalanche	nature
ave	architecture
avenue	architecture
avenues	infrastructure_transport
average	nature
averages	nature
averaging	nature
avery	nature
avoids	nature
avon	infrastructure_transport
await	nature
awaiting	infrastructure_transport
away	nature
axes	nature
axial	nature
axis	infrastructure_transport
axle	infrastructure_transport
azerbaijani	politics
azores	nature
babe	nature
babies	nature
baby	nature
babylon	infrastructure_transport
backlash	politics
backs	nature
backup	infrastructure_transport
backwards	nature
bacteria	nature
bacterial	nature
bacterium	nature
bafta	film
bag	nature
bags	nature
bahamas	nature
bahia	nature
bahn	infrastructure_transport
bail	politics
bailey	infrastructure_transport
bait	nature
baked	nature
bakery	economics
baking	economics
balcony	architecture
bald	nature
bali	infrastructure_transport
ball	nature
ballad	music
ballads	music
ballistic	infrastructure_transport
balloon	infrastructure_transport
ballot	politics
ballots	politics
ballroom	architecture
bamboo	nature
bananas	nature
band	music
banded	nature
bandits	nature
bang	politics
bangor	nature
banished	politics
bank	economics
bankers	economics
banking	economics
bankrupt	economics
bankruptcy	economics
banquet	infrastructure_transport
baptism	nature
barbados	nature
bare	nature
barely	nature
bargaining	politics
barge	infrastructure_transport
barges	infrastructure_transport
bark	nature
barley	nature
barlow	nature
barn	architecture
baron	politics
baroness	politics
baronet	politics
baronetcy	politics
baroque	architecture
barra	nature
barracks	architecture
barrel	infrastructure_transport
barren	nature
barriers	infrastructure_transport
barrio	nature
barrister	politics
barrow	nature
basal	nature
basalt	nature
baseline	nature
baseman	athletics
basement	architecture
basilica	architecture
basin	nature
basins	nature
basketball	athletics
bat	nature
bates	nature
bath	infrastructure_transport
bathing	nature
bathroom	infrastructure_transport
baths	architecture
bathurst	infrastructure_transport
bats	nature
batsman	athletics
battalion	war
battalions	war
batted	athletics
batter	nature
batteries	infrastructure_transport
batting	athletics
battle	war
battleship	infrastructure_transport
battleships	infrastructure_transport
bay	nature
bays	architecture
bbc	film
beach	nature
beaches	nature
beads	nature
beam	infrastructure_transport
beams	architecture
bean	nature
beans	nature
bear	nature
beard	nature
bearing	infrastructure_transport
bears	nature
beast	nature
beasts	nature
beaufort	infrastructure_transport
beautiful	nature
beautifully	nature
beauty	nature
beaver	nature
bec	politics
becomes	nature
bed	nature
bedford	infrastructure_transport
bedrock	nature
bedroom	architecture
bedrooms	architecture
beds	nature
bee	nature
beech	nature
bees	nature
beetle	nature
beetles	nature
beg	nature
begging	nature
begin	infrastructure_transport
begins	nature
begs	nature
behavior	nature
behavioral	nature
behaviors	nature
behaviour	nature
beings	nature
beliefs	politics
believe	nature
believed	nature
belize	nature
bell	infrastructure_transport
bella	nature
bells	architecture
belly	nature
belong	nature
belonging	nature
belongings	nature
belongs	nature
below	nature
belt	nature
belts	nature
bend	infrastructure_transport
bending	nature
bends	nature
beneficial	nature
benefits	nature
benito	nature
bentley	infrastructure_transport
benton	nature
bermuda	nature
bernardino	infrastructure_transport
berries	nature
berry	nature
berth	nature
besieged	war
beth	nature
between	infrastructure_transport
beverage	politics
beverages	politics
bharatiya	politics
bhutan	nature
bi	politics
biblical	nature
bibliography	infrastructure_transport
bicycles	economics
bidding	infrastructure_transport
biennial	nature
big	nature
bihar	politics
bike	infrastructure_transport
bikes	infrastructure_transport
biking	nature
billed	nature
billie	nature
billions	nature
binary	nature
biodiversity	nature
biological	nature
biologist	nature
biology	nature
biotechnology	politics
biplane	infrastructure_transport
birch	nature
bird	nature
birds	nature
birth	nature
birthplace	architecture
births	nature
bisexual	nature
bishopric	politics
bishops	politics
bit	nature
bite	nature
bites	nature
biting	nature
bitterly	politics
black	nature
blackish	nature
blades	nature
bland	nature
blank	nature
blaze	nature
bleeding	nature
blend	infrastructure_transport
blends	nature
bless	nature
blessing	nature
blessings	nature
blindness	nature
bloc	politics
block	architecture
blockbuster	film
blocked	infrastructure_transport
blocks	architecture
blonde	nature
blood	nature
bloom	nature
bloomfield	nature
blossom	nature
blue	nature
bluff	nature
bluish	nature
blunt	nature
bmg	politics
boasted	infrastructure_transport
boasts	nature
boat	infrastructure_transport
boating	nature
boats	infrastructure_transport
boca	nature
bodied	infrastructure_transport
bodies	nature
bodily	nature
body	nature
bog	nature
boiler	infrastructure_transport
boilers	infrastructure_transport
boiling	nature
bol	war
bold	nature
bolivia	nature
bollywood	film
bolshevik	politics
bolt	infrastructure_transport
bombardment	war
bombed	war
bombers	infrastructure_transport
bombing	war
bone	nature
bones	nature
bono	nature
bookstore	economics
booming	economics
boost	infrastructure_transport
boot	infrastructure_transport
booth	infrastructure_transport
boots	infrastructure_transport
border	nature
bordering	nature
borders	nature
bore	infrastructure_transport
boring	nature
boris	politics
borne	nature
borneo	nature
boroughs	nature
botanic	nature
botanical	nature
botanist	nature
botany	nature
botswana	nature
bottle	infrastructure_transport
bottom	nature
bought	economics
boulder	nature
boulders	nature
boulevard	infrastructure_transport
bounce	nature
boundaries	nature
boundary	nature
bounded	nature
bounds	nature
bourgeois	politics
boutique	politics
bouts	nature
bow	infrastructure_transport
bowen	nature
bowie	nature
bowled	athletics
bowler	athletics
bowman	nature
boxer	nature
boxes	infrastructure_transport
boys	nature
bp	politics
bracket	infrastructure_transport
brahmin	nature
brain	nature
brains	nature
brake	infrastructure_transport
brakes	infrastructure_transport
braking	infrastructure_transport
branching	nature
branded	politics
brands	politics
bravery	war
breadth	nature
breakfast	nature
breaks	nature
breast	nature
breath	nature
breathe	nature
breathing	nature
bred	nature
breed	nature
breeding	nature
breeds	nature
breeze	nature
bremen	nature
brenda	nature
brendan	nature
brent	nature
breuning	nature
brewers	economics
brewery	economics
brewing	economics
bribery	politics
brick	architecture
bricks	architecture
bridge	infrastructure_transport
bridges	infrastructure_transport
brig	infrastructure_transport
brigade	war
brigadier	war
briggs	nature
bright	nature
brighter	nature
brightest	nature
brightly	nature
brightness	nature
brings	nature
brisbane	infrastructure_transport
britannia	infrastructure_transport
broad	nature
broadband	politics
broadcast	film
broadcasting	film
broadcasts	film
broken	infrastructure_transport
bronx	nature
brook	nature
brooklyn	nature
brooks	nature
brown	nature
brownish	nature
browns	nature
brunei	nature
brush	nature
bryant	nature
bubbles	nature
buck	nature
bucket	nature
bud	nature
buddha	nature
buddhism	nature
buff	nature
buffalo	nature
buffer	infrastructure_transport
bug	nature
bugs	nature
build	architecture
builder	architecture
building	architecture
buildings	architecture
built	architecture
bull	nature
bulldogs	athletics
bulls	nature
bunch	nature
bundesliga	athletics
bundle	nature
bungalow	architecture
bunny	nature
bureaucracy	politics
bureaucratic	politics
burial	architecture
burials	architecture
burke	nature
burkina	politics
burn	nature
burned	architecture
burnett	nature
burning	nature
burns	nature
burr	nature
burrows	nature
burst	nature
bursts	nature
burt	nature
bus	infrastructure_transport
buses	infrastructure_transport
bush	nature
bushes	nature
business	economics
businesses	economics
businessmen	economics
bust	infrastructure_transport
butch	nature
butler	nature
butt	nature
butter	nature
butterflies	nature
butterfly	nature
buy	economics
buyer	economics
buyers	infrastructure_transport
buying	economics
bypass	infrastructure_transport
bypassed	infrastructure_transport
bypassing	infrastructure_transport
byrd	nature
ca	politics
cab	infrastructure_transport
cabin	infrastructure_transport
cabinet	politics
cabins	infrastructure_transport
cables	infrastructure_transport
cactus	nature
cadillac	infrastructure_transport
cadre	politics
cafeteria	architecture
cairns	nature
cake	nature
calcium	nature
calculate	infrastructure_transport
calculated	infrastructure_transport
calculation	infrastructure_transport
calculations	infrastructure_transport
caledonia	nature
calf	nature
calgary	nature
calhoun	nature
caliber	infrastructure_transport
calm	nature
calvin	nature
camel	infrastructure_transport
cameo	film
camera	film
cameras	film
cameroon	nature
campaign	politics
campaigned	politics
campaigner	politics
campaigning	politics
campaigns	politics
campbell	nature
camped	nature
campeonato	athletics
campus	architecture
can	nature
canals	nature
canary	nature
canceled	infrastructure_transport
cancellation	infrastructure_transport
cancelled	infrastructure_transport
candidacy	politics
candidate	politics
candidates	politics
candle	nature
candles	nature
cane	nature
cannons	infrastructure_transport
cannot	nature
canoe	nature
canonical	infrastructure_transport
canopy	nature
cans	politics
canterbury	nature
cantonese	nature
canyon	nature
capability	infrastructure_transport
capable	nature
cape	nature
capitalism	politics
capitals	infrastructure_transport
capitol	architecture
capped	athletics
caps	athletics
capsule	nature
captained	athletics
captive	nature
car	infrastructure_transport
carbon	nature
carbonate	nature
cardiovascular	politics
careful	nature
carefully	nature
cargo	infrastructure_transport
caribbean	nature
carla	nature
carleton	nature
carlisle	nature
carmel	nature
carnegie	nature
carniola	nature
carolina	nature
carpet	infrastructure_transport
carriage	infrastructure_transport
carriages	infrastructure_transport
carrie	infrastructure_transport
carrier	infrastructure_transport
carriers	infrastructure_transport
carries	nature
carroll	nature
carry	infrastructure_transport
carrying	infrastructure_transport
cars	infrastructure_transport
carson	nature
cart	infrastructure_transport
cartoon	film
carved	architecture
carver	infrastructure_transport
carving	architecture
carvings	architecture
casa	architecture
cascade	nature
cases	nature
casey	nature
casino	infrastructure_transport
cass	nature
cast	film
caste	nature
castes	politics
castile	politics
casting	film
castle	architecture
castles	architecture
cat	nature
catalogue	economics
catalyzes	nature
catastrophic	infrastructure_transport
catch	nature
catches	nature
catching	nature
catchment	nature
categorized	nature
catering	economics
caters	politics
catfish	nature
cathedral	architecture
catholicism	politics
catholics	politics
cats	nature
cattle	nature
caucasian	nature
caucasus	nature
caucus	politics
caught	nature
causeway	infrastructure_transport
causing	nature
cavalry	war
cave	nature
caves	nature
cavity	nature
cbc	film
cbs	film
cc	infrastructure_transport
cdp	politics
ceasefire	politics
cedar	nature
ceiling	architecture
ceilings	architecture
celebration	nature
celestial	nature
cell	nature
cellar	architecture
cells	nature
cemeteries	architecture
cemetery	architecture
censorship	politics
census	populated_areas
cent	infrastructure_transport
centennial	infrastructure_transport
centerpiece	infrastructure_transport
centimeters	nature
central	nature
centrally	architecture
cerambycidae	nature
ceramic	politics
ceremonial	infrastructure_transport
ceremonies	infrastructure_transport
cerro	nature
certainly	nature
certainty	nature
cfl	athletics
chain	economics
chairmanship	politics
chairperson	politics
chalk	nature
challenger	nature
champ	infrastructure_transport
champions	athletics
championship	athletics
championships	athletics
chancel	architecture
chancellor	politics
changes	nature
channel	film
channels	film
chanting	nature
chapel	architecture
chapels	architecture
characterised	nature
characteristic	nature
characteristics	nature
characterized	nature
charcoal	nature
chargers	nature
charges	politics
charging	infrastructure_transport
charismatic	politics
charlotte	nature
charm	nature
charming	nature
chart	music
charted	music
charting	music
charts	music
chase	nature
chased	nature
chases	nature
chasing	nature
chassis	infrastructure_transport
cheaper	infrastructure_transport
checking	infrastructure_transport
cheek	nature
cheer	nature
cheese	politics
chemically	nature
cherokee	nature
cherry	nature
cheryl	nature
chesapeake	nature
chest	nature
chevrolet	infrastructure_transport
cheyenne	nature
chichester	nature
chick	nature
chickens	nature
chief	politics
chiefs	politics
childless	politics
chili	nature
chimney	architecture
chimneys	architecture
chloride	nature
cho	nature
cholera	nature
chooses	nature
chords	music
choreography	film
chosen	infrastructure_transport
christianity	politics
christians	politics
chrome	infrastructure_transport
chromosome	nature
chronic	nature
chronological	infrastructure_transport
chronology	infrastructure_transport
chrysler	infrastructure_transport
church	architecture
churches	architecture
churchyard	architecture
cincinnati	nature
cindy	nature
cinema	film
cinemas	film
cinematic	film
cinematography	film
circa	architecture
circuit	infrastructure_transport
circuits	infrastructure_transport
circular	infrastructure_transport
circulation	economics
circumstance	nature
citadel	infrastructure_transport
citizens	politics
citizenship	politics
citrus	nature
civic	politics
clade	nature
claim	nature
clair	nature
clan	nature
clara	nature
clare	nature
clarence	nature
clarity	nature
clarke	nature
clarkson	nature
clashed	politics
clashes	politics
class	infrastructure_transport
classed	infrastructure_transport
classically	infrastructure_transport
classification	nature
classifications	nature
classified	infrastructure_transport
classify	nature
classrooms	architecture
claw	nature
claws	nature
clean	nature
cleaner	infrastructure_transport
clear	nature
clearance	infrastructure_transport
cleared	infrastructure_transport
clearly	nature
clergy	politics
clergyman	politics
clerical	politics
cleveland	nature
clients	economics
cliff	nature
cliffs	nature
climate	nature
climates	nature
climatic	nature
climb	nature
climbed	nature
climbing	nature
climbs	nature
clint	nature
clip	film
clips	film
clockwise	nature
clone	infrastructure_transport
close	nature
closely	nature
closer	nature
closes	nature
closest	nature
cloud	nature
clouds	nature
club	athletics
clube	athletics
clubhouse	architecture
cluster	nature
clustered	nature
clusters	nature
clutch	nature
clyde	infrastructure_transport
cm	nature
coach	athletics
coached	athletics
coaching	athletics
coalition	politics
coarse	nature
coast	nature
coastal	nature
coaster	infrastructure_transport
coastline	nature
coasts	nature
coated	nature
coats	nature
cobb	infrastructure_transport
coca	nature
cocaine	nature
cockpit	infrastructure_transport
cocktail	nature
coconut	nature
cod	nature
code	infrastructure_transport
codes	infrastructure_transport
cody	nature
coefficient	nature
coefficients	nature
coffin	infrastructure_transport
coil	infrastructure_transport
coin	infrastructure_transport
coincide	infrastructure_transport
coincidence	nature
coincides	nature
coinciding	infrastructure_transport
coined	politics
colder	nature
coll	architecture
collaborative	politics
collapsed	architecture
collapses	nature
collected	nature
collided	infrastructure_transport
colliery	economics
collision	infrastructure_transport
colloquial	nature
colombia	nature
colon	nature
colonel	war
colonialism	politics
colonies	nature
colonists	nature
colonization	nature
colony	nature
color	nature
colorado	nature
coloration	nature
colored	nature
colorful	nature
coloring	nature
colors	nature
colour	nature
coloured	nature
colourful	nature
colours	nature
colt	infrastructure_transport
columbus	nature
combination	infrastructure_transport
combinations	nature
come	nature
comedians	film
comedic	film
comedies	film
comedy	film
comes	nature
comet	nature
comfort	infrastructure_transport
comfortable	nature
comfortably	nature
command	war
commanded	war
commander	war
commanding	war
commando	war
commemorate	infrastructure_transport
commemorated	infrastructure_transport
commemorates	infrastructure_transport
commemorating	infrastructure_transport
commence	infrastructure_transport
commercial	economics
commercially	politics
commission	politics
commissioned	infrastructure_transport
commissioner	politics
commissioning	infrastructure_transport
committee	politics
committees	politics
commodore	infrastructure_transport
common	nature
commonly	nature
commons	politics
communal	politics
commune	politics
communion	nature
communism	politics
communist	politics
communists	politics
commute	nature
commuters	infrastructure_transport
como	nature
compact	nature
companies	economics
companions	nature
company	economics
comparable	nature
comparatively	nature
compare	infrastructure_transport
compared	nature
compares	nature
comparison	nature
comparisons	nature
compartment	infrastructure_transport
compatibility	infrastructure_transport
compatible	infrastructure_transport
compensate	infrastructure_transport
compensated	infrastructure_transport
competence	politics
competitors	infrastructure_transport
compilation	music
complaint	politics
complement	infrastructure_transport
complemented	infrastructure_transport
complete	infrastructure_transport
completed	architecture
completely	infrastructure_transport
completes	infrastructure_transport
completion	infrastructure_transport
complex	architecture
complexes	architecture
compliant	infrastructure_transport
comply	infrastructure_transport
component	infrastructure_transport
components	infrastructure_transport
composite	infrastructure_transport
compositions	music
compounded	infrastructure_transport
compounds	nature
compressed	nature
compression	infrastructure_transport
comprise	nature
comprising	nature
compromise	politics
compulsory	politics
compute	infrastructure_transport
computed	infrastructure_transport
computers	infrastructure_transport
computing	politics
concacaf	athletics
concave	nature
conceived	infrastructure_transport
concentration	nature
concentrations	nature
concept	infrastructure_transport
concert	music
concerto	music
concession	economics
concessions	economics
conclude	nature
concludes	nature
conclusion	nature
concrete	architecture
concurrency	nature
concurrent	infrastructure_transport
condemnation	politics
condemned	politics
condemning	politics
conditioned	infrastructure_transport
conditioning	infrastructure_transport
conditions	nature
conducts	politics
cone	nature
cones	nature
confederacy	politics
confederation	politics
confer	nature
confesses	nature
confidence	politics
confident	nature
configuration	infrastructure_transport
configurations	infrastructure_transport
configured	infrastructure_transport
confined	nature
confirm	nature
confirms	nature
conflict	politics
conflicting	nature
conflicts	politics
confluence	nature
conform	infrastructure_transport
confronts	nature
confused	nature
confusing	infrastructure_transport
confusion	nature
congestion	infrastructure_transport
congo	nature
congregation	architecture
congregational	architecture
congress	politics
congresses	politics
congressional	politics
congressman	politics
conical	nature
conjecture	nature
conjunction	infrastructure_transport
connect	infrastructure_transport
connected	infrastructure_transport
connecticut	nature
connection	infrastructure_transport
connector	infrastructure_transport
conqueror	infrastructure_transport
conscience	politics
consecrated	architecture
consecration	architecture
consensus	nature
conservation	nature
conservative	politics
conservatives	politics
conserve	infrastructure_transport
consider	nature
considerably	infrastructure_transport
consideration	infrastructure_transport
considers	nature
consist	nature
consistency	nature
consistent	nature
consistently	nature
consisting	nature
consists	nature
consolation	nature
console	video_game
consoles	video_game
consolidated	economics
consortium	politics
conspicuous	nature
conspiracy	politics
conspirators	politics
constance	nature
constituencies	politics
constituency	politics
constituent	politics
constituents	politics
constitute	nature
constituted	politics
constitutes	nature
constituting	nature
constitution	politics
constitutional	politics
constrained	infrastructure_transport
constraints	infrastructure_transport
construct	architecture
constructed	architecture
constructing	architecture
construction	architecture
constructions	architecture
constructive	politics
constructs	infrastructure_transport
consul	politics
consultative	politics
consulting	economics
consume	nature
consumed	nature
consumers	politics
consuming	nature
consumption	nature
contain	nature
containing	nature
contains	nature
contaminated	nature
contamination	nature
contempt	politics
contend	nature
contender	nature
contenders	nature
contention	nature
contestant	nature
contestants	film
context	politics
contiguous	nature
continent	nature
continents	nature
continues	nature
contracted	infrastructure_transport
contracting	economics
contractors	economics
contracts	economics
contrast	nature
contrasting	nature
contrasts	nature
contribute	nature
contributes	nature
controls	video_game
controversies	politics
convened	politics
convenience	infrastructure_transport
convent	architecture
conventional	infrastructure_transport
converge	nature
converse	infrastructure_transport
conversely	nature
conversion	infrastructure_transport
conversions	infrastructure_transport
convert	architecture
converted	architecture
converts	nature
convex	nature
convicted	politics
conviction	politics
convictions	politics
convoy	war
cook	nature
cooked	nature
cool	nature
cooled	infrastructure_transport
cooler	nature
cooling	infrastructure_transport
coordination	politics
copied	infrastructure_transport
copy	infrastructure_transport
coral	nature
cord	infrastructure_transport
corn	nature
cornell	nature
corner	architecture
corners	infrastructure_transport
cornerstone	architecture
cornice	architecture
cornwall	nature
corona	nature
coronation	infrastructure_transport
coroner	nature
corp	politics
corporal	war
corporations	economics
corps	war
corpus	politics
correct	nature
corrected	infrastructure_transport
correctional	politics
correctly	nature
correlated	nature
correlation	nature
correspond	nature
correspondent	politics
corresponding	nature
corresponds	nature
corridor	infrastructure_transport
corridors	infrastructure_transport
corrupt	politics
corrupted	politics
corruption	politics
cortex	nature
corvette	infrastructure_transport
cory	nature
cosmopolitan	nature
cosmos	nature
cost	infrastructure_transport
costa	nature
costal	nature
costing	infrastructure_transport
costly	infrastructure_transport
costs	infrastructure_transport
costumes	film
cottage	architecture
cottages	architecture
couch	nature
council	politics
councillor	politics
councillors	politics
councils	politics
counsel	politics
counsellor	politics
countdown	film
counted	nature
counterattack	war
counterpart	infrastructure_transport
counties	nature
countryside	nature
coup	politics
coupe	infrastructure_transport
coupled	infrastructure_transport
coupling	nature
course	infrastructure_transport
courthouse	architecture
courtship	nature
courtyard	architecture
cove	nature
covered	nature
covers	nature
coveted	nature
cow	nature
cowboys	nature
cows	nature
crab	nature
crabs	nature
crack	nature
cracking	nature
cracks	architecture
cradle	nature
craft	infrastructure_transport
crafted	infrastructure_transport
craftsman	architecture
craftsmen	architecture
crambidae	nature
crane	infrastructure_transport
crashed	infrastructure_transport
crashes	infrastructure_transport
crashing	infrastructure_transport
crater	nature
cream	nature
create	infrastructure_transport
creature	nature
creatures	nature
credentials	politics
creek	nature
creeks	nature
crescent	infrastructure_transport
crest	nature
cretaceous	nature
crete	nature
crews	infrastructure_transport
cricket	athletics
cricketer	athletics
cries	nature
crimes	politics
criminal	politics
crimson	nature
crises	politics
crisis	politics
crisp	nature
criterion	infrastructure_transport
criticised	politics
criticism	politics
criticize	politics
criticized	politics
criticizing	politics
critique	politics
crocodile	nature
crop	nature
crops	nature
crossed	nature
crosses	nature
crossing	nature
crossings	infrastructure_transport
crossroads	infrastructure_transport
crow	nature
crowd	nature
crowded	nature
crowds	nature
crowned	nature
cruise	infrastructure_transport
cruiser	infrastructure_transport
cruisers	infrastructure_transport
cruising	infrastructure_transport
crust	nature
crustaceans	nature
crying	nature
crypt	architecture
crystal	nature
crystalline	nature
crystals	nature
csi	film
ctor	nature
cu	infrastructure_transport
cubic	infrastructure_transport
cubs	nature
cues	nature
cuisine	nature
culinary	nature
cullen	nature
culmination	nature
cultivated	nature
cultivation	nature
cultures	nature
cumberland	nature
cumbria	nature
cup	athletics
cupola	architecture
curate	architecture
cure	nature
curiosity	nature
curious	nature
curling	nature
currents	nature
currie	nature
curry	nature
curtis	nature
curve	infrastructure_transport
curved	nature
curves	nature
curving	nature
custody	politics
custom	infrastructure_transport
customer	economics
customers	economics
cut	infrastructure_transport
cutter	infrastructure_transport
cycle	nature
cyclic	nature
cyclist	athletics
cyclone	infrastructure_transport
cyclones	nature
cylinder	infrastructure_transport
cylinders	infrastructure_transport
cylindrical	nature
cypress	nature
cz	war
dagger	nature
dairy	economics
daisy	nature
dakota	nature
dal	politics
dale	nature
dalton	nature
daly	nature
dam	architecture
damp	nature
dams	architecture
danger	nature
dante	infrastructure_transport
danube	nature
darker	nature
darkgrey	nature
darling	nature
darren	nature
dart	infrastructure_transport
darwin	nature
dash	infrastructure_transport
data	nature
database	infrastructure_transport
date	infrastructure_transport
dates	architecture
dating	infrastructure_transport
dawson	nature
daylight	nature
daytona	infrastructure_transport
dead	nature
dealer	economics
dealers	economics
deanery	architecture
debated	nature
debates	politics
debbie	nature
debris	nature
decay	architecture
deciduous	nature
decisive	politics
decisively	politics
deck	infrastructure_transport
decks	infrastructure_transport
declaration	politics
declares	nature
decline	nature
declines	nature
deco	infrastructure_transport
decommissioned	infrastructure_transport
decomposition	nature
decorate	architecture
decorative	architecture
decrease	nature
decreased	nature
decreases	nature
decreasing	nature
decree	politics
decrees	politics
dee	nature
deemed	infrastructure_transport
deep	nature
deeper	nature
deepest	nature
deer	nature
defamation	politics
default	infrastructure_transport
defected	politics
defects	nature
defended	politics
defender	athletics
defensive	nature
deficiencies	infrastructure_transport
definite	nature
definitely	nature
definition	infrastructure_transport
definitive	nature
deforestation	nature
defunct	politics
degradation	nature
degraded	nature
degrees	nature
dehestan	politics
dei	infrastructure_transport
deity	nature
delay	infrastructure_transport
delayed	infrastructure_transport
delays	infrastructure_transport
delegate	politics
delegates	politics
delegation	politics
deliberate	nature
delicate	nature
delight	nature
delighted	nature
deliver	infrastructure_transport
delivered	infrastructure_transport
deliveries	infrastructure_transport
delivers	nature
delivery	infrastructure_transport
delta	nature
deluxe	politics
demanded	politics
democracy	politics
democrat	politics
democratic	politics
democrats	politics
demolish	architecture
demolished	architecture
demolition	architecture
demon	infrastructure_transport
demonstrations	politics
denies	nature
denote	nature
denotes	nature
denoting	infrastructure_transport
denounced	politics
dense	nature
densely	nature
density	nature
denver	nature
departs	nature
departures	nature
depend	nature
depends	nature
depleted	infrastructure_transport
deploy	infrastructure_transport
deportation	politics
deported	politics
deportivo	athletics
deposed	politics
deposit	nature
deposited	nature
deposits	nature
depot	infrastructure_transport
depots	infrastructure_transport
depressed	nature
deprived	politics
depth	nature
depths	nature
deputies	politics
deputy	politics
derelict	architecture
derivation	nature
derivative	infrastructure_transport
derive	nature
derived	nature
derives	nature
descend	nature
descended	nature
descending	nature
descends	nature
descent	nature
described	nature
description	infrastructure_transport
desert	nature
deserts	nature
deserve	nature
deserves	nature
designate	infrastructure_transport
designated	infrastructure_transport
designation	infrastructure_transport
designations	infrastructure_transport
designed	architecture
designs	infrastructure_transport
desirable	nature
despite	nature
destination	nature
destinations	infrastructure_transport
destined	infrastructure_transport
destroyed	architecture
destroyer	infrastructure_transport
destroyers	infrastructure_transport
det	politics
detachment	war
detailed	infrastructure_transport
details	infrastructure_transport
detained	politics
detect	nature
detected	nature
detecting	infrastructure_transport
detection	infrastructure_transport
detector	infrastructure_transport
detention	politics
deteriorated	architecture
deteriorating	architecture
deterioration	architecture
determined	nature
determines	nature
determining	nature
devastating	nature
developers	video_game
developmental	nature
develops	politics
deviation	nature
device	infrastructure_transport
devices	infrastructure_transport
devil	nature
devils	nature
devoid	nature
devotees	nature
dexter	nature
dharma	politics
dia	politics
diabetes	nature
diagnosis	nature
diagonal	infrastructure_transport
diagram	infrastructure_transport
dial	infrastructure_transport
dialect	nature
dialects	nature
dialogues	film
diameter	nature
diamonds	nature
diana	nature
diane	nature
dice	video_game
dickinson	nature
dictated	infrastructure_transport
dictator	politics
dictatorship	politics
diego	nature
diet	nature
dietary	nature
dietrich	infrastructure_transport
differ	nature
differed	infrastructure_transport
difference	nature
differences	nature
different	infrastructure_transport
differential	nature
differentiated	nature
differentiation	infrastructure_transport
differently	nature
differing	nature
differs	nature
difficult	nature
diffuse	nature
diffusion	politics
digging	nature
digit	infrastructure_transport
digits	nature
dignity	politics
dilapidated	architecture
dimensions	infrastructure_transport
diminutive	nature
dinamo	athletics
dining	infrastructure_transport
dinner	nature
dinosaur	nature
dinosaurs	nature
diocesan	architecture
diocese	architecture
dioxide	nature
dip	nature
diplomat	politics
diplomatic	politics
directed	film
directing	film
directive	politics
directorate	politics
directorial	film
directs	politics
dirt	nature
disadvantages	nature
disagree	nature
disagreed	politics
disappear	nature
disappearing	nature
disappears	nature
disappointing	nature
disappointment	nature
discal	nature
discarded	infrastructure_transport
discharges	nature
disciples	nature
discontent	politics
discontinued	infrastructure_transport
discount	economics
discourse	politics
discover	nature
discovered	nature
discrete	nature
discrimination	politics
discriminatory	politics
discus	athletics
disease	nature
diseases	nature
dish	nature
dishes	nature
disillusioned	politics
disks	infrastructure_transport
dismantled	architecture
dismissal	politics
disney	film
disorder	politics
dispatches	war
dispersal	nature
disperse	nature
dispersed	nature
displacement	infrastructure_transport
display	infrastructure_transport
displayed	infrastructure_transport
displaying	infrastructure_transport
displays	infrastructure_transport
disputed	nature
disputes	politics
disrepair	architecture
dissent	politics
dissident	politics
dissolution	politics
dissolve	politics
distance	nature
distances	nature
distant	nature
distinct	nature
distinctive	nature
distinctly	nature
distinguish	nature
distinguishes	nature
distinguishing	nature
distortion	nature
distraught	nature
distribute	economics
distributes	politics
distributing	economics
distribution	economics
distributions	nature
district	politics
disturbance	nature
disturbances	politics
disturbed	nature
disused	infrastructure_transport
ditch	nature
ditches	nature
diva	nature
dive	nature
diver	nature
diversion	infrastructure_transport
diversity	nature
diverted	infrastructure_transport
divide	nature
divided	nature
divides	nature
dividing	nature
diving	infrastructure_transport
divorce	politics
dixon	nature
dmitry	politics
dna	nature
do	nature
doc	nature
dock	infrastructure_transport
docked	infrastructure_transport
docks	infrastructure_transport
dockyard	infrastructure_transport
doctrine	politics
doctrines	politics
documentaries	film
documentary	film
dodge	infrastructure_transport
does	nature
doesn	nature
dog	nature
dogs	nature
doha	nature
doll	infrastructure_transport
dolly	nature
dolores	nature
dolphin	nature
dolphins	nature
domains	politics
dome	architecture
domed	architecture
domenico	infrastructure_transport
domestically	politics
dominant	nature
dominates	nature
dominating	nature
domination	politics
done	infrastructure_transport
donegal	nature
donna	nature
donnell	nature
donor	nature
doorway	architecture
dormant	nature
dormitory	architecture
dorsal	nature
dorsum	nature
dose	nature
doses	nature
dots	nature
dotted	nature
doubling	infrastructure_transport
doubted	nature
doubtful	nature
dove	nature
dow	politics
downed	war
downfall	politics
downhill	nature
downloadable	video_game
downs	nature
downstream	nature
downtown	architecture
downturn	economics
downward	nature
downwards	nature
dragged	nature
drain	nature
drainage	nature
drained	nature
draining	nature
drains	nature
drama	film
dramas	film
dramatic	film
drank	nature
drastically	infrastructure_transport
draught	infrastructure_transport
drawn	infrastructure_transport
draws	nature
dress	infrastructure_transport
dressed	nature
dresses	infrastructure_transport
dressing	infrastructure_transport
dried	nature
drift	nature
drifted	nature
drifting	nature
drilled	infrastructure_transport
drink	nature
drinking	nature
drive	infrastructure_transport
driven	infrastructure_transport
driver	infrastructure_transport
drivers	infrastructure_transport
drives	infrastructure_transport
driving	infrastructure_transport
drone	infrastructure_transport
drop	nature
dropping	nature
drops	nature
drought	nature
drowned	nature
drowning	nature
drug	nature
drury	nature
dry	nature
drying	nature
ds	video_game
duchy	politics
duck	nature
ducks	nature
due	infrastructure_transport
duet	music
duets	music
dull	nature
dump	nature
dumped	nature
dumping	nature
dunes	nature
dungeon	video_game
dungeons	video_game
duplicate	infrastructure_transport
durability	infrastructure_transport
durable	infrastructure_transport
dusk	nature
dust	nature
dusty	nature
dvd	film
dwarf	nature
dwellers	nature
dwelling	architecture
dwellings	architecture
dye	nature
dyke	nature
dylan	nature
dynastic	politics
each	nature
eagle	infrastructure_transport
eagles	nature
ear	nature
earle	nature
earlier	infrastructure_transport
earns	nature
ears	nature
earth	nature
earthquake	architecture
ease	infrastructure_transport
easier	infrastructure_transport
easily	nature
east	nature
eastbound	infrastructure_transport
easter	nature
easterly	nature
eastern	nature
easternmost	nature
easton	infrastructure_transport
eastward	nature
eastwards	nature
easy	nature
eat	nature
eaten	nature
eating	nature
eats	nature
eccentric	nature
ecclesiastical	politics
echo	nature
ecological	nature
ecology	nature
economics	economics
economies	economics
economist	economics
economists	economics
economy	economics
ecosystem	nature
ecosystems	nature
ecuador	nature
eden	nature
edge	nature
edged	nature
edges	nature
edible	nature
edict	politics
editing	film
editorials	politics
edmonton	nature
edna	nature
edo	infrastructure_transport
educated	politics
efficacy	nature
egg	nature
eggs	nature
eight	nature
ein	politics
either	nature
elaborate	architecture
elbow	nature
elderly	nature
eldest	politics
elect	politics
elected	politics
electing	politics
election	politics
elections	politics
elective	politics
elector	politics
electoral	politics
electorate	politics
electors	politics
electrically	infrastructure_transport
electro	politics
electromagnetic	infrastructure_transport
electronica	politics
electronically	infrastructure_transport
electronics	politics
electrons	nature
elementary	architecture
elephant	nature
elephants	nature
elevation	nature
elevations	nature
elevator	infrastructure_transport
elevators	infrastructure_transport
eleventh	nature
elgin	infrastructure_transport
eligible	nature
elijah	nature
elimination	nature
elites	politics
eliza	nature
elk	nature
ellen	nature
ellington	nature
elliptical	nature
ellis	nature
elongated	nature
else	nature
elsewhere	nature
elusive	nature
emancipation	politics
embankment	infrastructure_transport
emblem	infrastructure_transport
embraces	nature
emerald	nature
emerge	nature
emerges	nature
emil	politics
emily	nature
emir	politics
emission	nature
emitted	nature
emma	nature
emmy	film
emphasize	infrastructure_transport
emphasizes	nature
empires	video_game
employees	economics
employer	economics
employers	economics
employing	economics
employs	politics
empowerment	politics
empress	infrastructure_transport
empties	nature
empty	nature
emulate	infrastructure_transport
enable	infrastructure_transport
enclosed	infrastructure_transport
enclosure	architecture
encoded	war
encoding	nature
encompasses	nature
encompassing	nature
encountered	nature
encourages	nature
endangered	nature
endeavour	nature
endemic	nature
ends	nature
endurance	infrastructure_transport
endure	nature
enforce	politics
engaged	politics
engagement	politics
engine	infrastructure_transport
engined	infrastructure_transport
engines	infrastructure_transport
englishman	nature
enhance	infrastructure_transport
enhanced	infrastructure_transport
enhancement	nature
enjoy	nature
enjoys	nature
enlarged	architecture
enlightenment	politics
enlisted	war
enough	nature
enraged	nature
enrichment	nature
enroll	nature
enrollment	architecture
ensues	nature
ensures	nature
enter	infrastructure_transport
enters	nature
enthusiasts	nature
entire	nature
entities	economics
entity	economics
entrance	infrastructure_transport
entrances	infrastructure_transport
entrants	infrastructure_transport
entrenched	politics
envelope	infrastructure_transport
environment	nature
environmentally	nature
environments	nature
envisaged	infrastructure_transport
envisioned	infrastructure_transport
enzyme	nature
enzymes	nature
ep	music
episcopal	architecture
episode	film
episodes	film
epithet	nature
eponymous	politics
equality	politics
equally	nature
equation	infrastructure_transport
equations	nature
equator	nature
equatorial	nature
equip	infrastructure_transport
equipment	infrastructure_transport
equipped	infrastructure_transport
equity	economics
equivalent	infrastructure_transport
er	politics
era	infrastructure_transport
eras	infrastructure_transport
erebidae	nature
erect	architecture
erected	architecture
erection	architecture
erin	nature
eroded	nature
erosion	nature
erratic	nature
erroneously	nature
error	nature
errors	nature
erupted	politics
eruption	nature
escorts	infrastructure_transport
essence	nature
essentially	infrastructure_transport
est	politics
established	economics
establishments	economics
estadio	athletics
estates	politics
estimated	nature
estonian	politics
estuary	nature
ethics	politics
ethiopia	nature
ethnic	politics
etymology	nature
eucalyptus	nature
eurasian	nature
europeans	nature
ev	politics
evacuated	war
evacuation	war
evaluate	infrastructure_transport
evaluated	infrastructure_transport
evaluating	infrastructure_transport
evangelical	politics
even	nature
evenly	nature
ever	nature
evergreen	nature
everton	athletics
every	nature
evicted	politics
evidence	nature
evidently	nature
evolution	nature
evolutionary	nature
exactly	nature
example	infrastructure_transport
examples	infrastructure_transport
excavated	architecture
excavation	architecture
excavations	architecture
exceed	nature
exceeded	infrastructure_transport
exceeding	nature
exceeds	nature
excel	nature
excellent	nature
except	nature
exception	nature
exceptional	nature
exceptionally	nature
exceptions	nature
excited	nature
excitement	nature
exciting	nature
exclude	nature
excluding	nature
excursion	infrastructure_transport
exert	politics
exerted	politics
exhaust	infrastructure_transport
exhausted	nature
exhaustion	nature
exhibit	infrastructure_transport
exhibits	infrastructure_transport
exile	politics
exiled	politics
exiles	politics
exist	nature
existent	infrastructure_transport
existing	infrastructure_transport
exists	infrastructure_transport
exit	infrastructure_transport
exiting	nature
exits	infrastructure_transport
exotic	nature
expand	economics
expanded	economics
expanding	economics
expect	nature
expectation	nature
expected	infrastructure_transport
expects	nature
expedition	nature
expeditionary	war
expeditions	nature
expel	politics
expelled	politics
expenditures	politics
expensive	infrastructure_transport
experiencing	infrastructure_transport
experts	nature
explode	nature
explodes	nature
explorer	nature
explorers	nature
export	economics
exported	economics
exports	economics
exposed	nature
exposition	infrastructure_transport
expulsion	politics
extant	infrastructure_transport
extend	infrastructure_transport
extended	infrastructure_transport
extending	nature
extends	nature
extension	infrastructure_transport
extensions	architecture
extent	nature
exterior	architecture
externally	infrastructure_transport
extinct	nature
extinction	nature
extract	nature
extracted	nature
extracts	nature
extras	film
extreme	nature
extremely	nature
extremes	nature
extremity	nature
eye	nature
eyed	nature
eyes	nature
ezra	nature
fa	athletics
fabric	architecture
fabricated	infrastructure_transport
fabrics	economics
facade	architecture
face	nature
faces	nature
facial	infrastructure_transport
facilities	architecture
facility	architecture
facing	nature
fact	nature
faction	politics
factions	politics
factories	economics
factors	nature
factory	economics
fade	nature
fading	nature
fail	nature
fails	nature
faint	nature
fairfield	nature
fairly	nature
fairy	nature
faithful	nature
faiths	politics
falcon	infrastructure_transport
falkland	nature
fall	nature
falling	nature
falls	nature
false	nature
famer	athletics
far	nature
fared	nature
farmed	nature
farmer	politics
farmhouse	architecture
farms	economics
farther	nature
fascinating	nature
fascism	politics
fascist	politics
fashioned	infrastructure_transport
fast	infrastructure_transport
faster	infrastructure_transport
fat	nature
fatal	infrastructure_transport
fated	nature
fatty	nature
fault	nature
faults	nature
fauna	nature
favor	politics
favour	politics
fc	athletics
fe	nature
feared	politics
feasibility	war
feasible	infrastructure_transport
feast	nature
feather	nature
feathers	nature
feature	film
fed	nature
federally	nature
feed	nature
feeder	nature
feeding	nature
feeds	nature
feel	nature
feels	nature
feet	nature
female	nature
females	nature
feminine	infrastructure_transport
feminism	politics
feminist	politics
fence	infrastructure_transport
fern	nature
ferns	nature
ferrari	infrastructure_transport
ferries	infrastructure_transport
ferry	infrastructure_transport
fertile	nature
fertility	nature
festival	film
festivities	nature
feud	politics
feudal	politics
fever	nature
few	nature
fewer	nature
fia	infrastructure_transport
fiat	infrastructure_transport
fibers	nature
fictionalized	film
fief	politics
fielded	athletics
fielder	nature
fields	nature
fiercely	politics
fiery	nature
fiesta	nature
fifteen	nature
fifteenth	nature
fifth	nature
fifty	nature
fight	politics
figured	nature
fiji	nature
filippo	infrastructure_transport
filling	infrastructure_transport
fills	nature
film	film
filmed	film
filming	film
filmmaker	film
filmmakers	film
filmmaking	film
films	film
filter	nature
fin	nature
finale	film
finalists	nature
finalized	infrastructure_transport
finance	economics
financial	economics
financially	economics
financing	economics
finch	nature
find	nature
finding	nature
finds	nature
finely	nature
finer	nature
finger	nature
fingers	nature
finishers	nature
finite	nature
finnish	politics
fins	nature
fir	nature
fireplace	architecture
fires	nature
fireworks	nature
firm	economics
firms	economics
fish	nature
fisherman	nature
fishermen	nature
fishes	nature
fishing	nature
fit	infrastructure_transport
fitness	nature
fits	nature
fitted	infrastructure_transport
fitting	infrastructure_transport
fittings	architecture
fitzgerald	nature
fitzroy	nature
five	nature
fix	infrastructure_transport
fixed	infrastructure_transport
fixing	infrastructure_transport
fixture	athletics
fjord	nature
fk	athletics
flags	infrastructure_transport
flagship	politics
flame	nature
flames	nature
flank	nature
flanks	nature
flashback	film
flashbacks	film
flashes	nature
flat	nature
flattened	nature
flavor	nature
flavors	politics
flavour	nature
flaws	infrastructure_transport
fledged	nature
flees	nature
fleet	infrastructure_transport
fleets	infrastructure_transport
fleming	nature
flesh	nature
flexibility	infrastructure_transport
flies	nature
flight	infrastructure_transport
flights	infrastructure_transport
flint	nature
float	nature
floating	nature
floats	nature
flock	nature
flooded	infrastructure_transport
flooding	nature
floor	architecture
floors	architecture
flora	nature
floral	nature
florida	nature
flotilla	war
flow	nature
flowed	nature
flower	nature
flowering	nature
flowers	nature
flowing	nature
flown	infrastructure_transport
flows	nature
floyd	nature
fluctuations	nature
fluid	nature
flush	nature
fly	nature
foe	nature
foes	nature
fog	nature
fold	nature
folding	infrastructure_transport
folds	nature
foliage	nature
folks	nature
follow	nature
footage	film
football	athletics
footballer	athletics
footballers	athletics
footed	nature
foothills	nature
footpath	nature
forage	nature
force	war
ford	infrastructure_transport
fore	nature
forecast	infrastructure_transport
forehead	nature
forensic	nature
forerunner	infrastructure_transport
forest	nature
forested	nature
forestry	economics
forests	nature
forewing	nature
forewings	nature
forgiveness	nature
fork	nature
forks	infrastructure_transport
formation	nature
formations	nature
formats	infrastructure_transport
formatted	infrastructure_transport
formed	economics
forms	nature
formula	infrastructure_transport
formulas	infrastructure_transport
fortification	architecture
forty	nature
forwards	nature
fossil	nature
fossils	nature
foul	nature
found	nature
foundations	architecture
founders	economics
foundry	economics
fountain	architecture
fountains	architecture
four	nature
fourteenth	nature
fowler	nature
foxes	nature
fraction	nature
fracture	infrastructure_transport
fragile	nature
fragments	nature
frame	architecture
framed	infrastructure_transport
frames	infrastructure_transport
franchise	video_game
francs	infrastructure_transport
freak	nature
freedom	politics
freedoms	politics
freeway	infrastructure_transport
freezing	nature
freight	infrastructure_transport
fremantle	infrastructure_transport
frequencies	nature
frequency	infrastructure_transport
frequented	nature
frescoes	architecture
fresh	nature
freshman	nature
freshwater	nature
friar	nature
friars	nature
fried	nature
frigate	infrastructure_transport
frigates	infrastructure_transport
frightened	nature
fringes	nature
frog	nature
frogs	nature
frontal	nature
fronted	nature
frost	nature
frozen	nature
fruit	nature
fruits	nature
fry	nature
ft	nature
fuel	infrastructure_transport
fuels	politics
fujian	nature
fukuoka	nature
fullback	athletics
fully	infrastructure_transport
functional	infrastructure_transport
fungal	nature
fungi	nature
fungus	nature
funnel	infrastructure_transport
fur	nature
furnace	architecture
furnished	architecture
furnishings	architecture
furniture	economics
furthermore	nature
fuscous	nature
fused	nature
fuselage	infrastructure_transport
futures	politics
gaa	nature
gable	architecture
gabled	architecture
gables	architecture
gabon	nature
gaelic	nature
galactic	nature
galaxy	infrastructure_transport
galicia	politics
gallantry	war
galway	nature
gamble	nature
game	video_game
gameplay	video_game
games	video_game
gaming	video_game
gamma	nature
gap	nature
gaps	nature
garage	architecture
garbage	nature
gardener	nature
gardens	architecture
gardiner	nature
gasoline	infrastructure_transport
gastropod	nature
gate	infrastructure_transport
gates	infrastructure_transport
gateway	infrastructure_transport
gauge	infrastructure_transport
gearbox	infrastructure_transport
gelechiidae	nature
gem	nature
gems	nature
gen	politics
gene	nature
genera	nature
general	politics
generally	nature
generate	infrastructure_transport
generated	infrastructure_transport
generator	infrastructure_transport
generators	infrastructure_transport
generic	nature
genes	nature
genetic	nature
genetically	nature
genome	nature
gentle	nature
gently	nature
genuine	nature
genus	nature
geographic	nature
geographical	nature
geographically	nature
geologic	nature
geological	nature
geology	nature
geometridae	nature
georgia	nature
germanic	nature
gets	nature
ghost	infrastructure_transport
giant	nature
gifted	nature
gig	music
gigantic	nature
gilan	politics
gilded	infrastructure_transport
gill	nature
gin	infrastructure_transport
ginger	nature
given	infrastructure_transport
gives	nature
glacial	nature
glacier	nature
glaciers	nature
glamour	nature
glands	nature
glazed	architecture
glen	nature
glendale	politics
glenn	nature
glider	infrastructure_transport
globally	politics
glossy	nature
glow	nature
glowing	nature
glucose	nature
goa	nature
goalkeeper	athletics
goalscorer	athletics
goaltender	nature
goat	nature
goats	nature
god	nature
goddard	nature
goddess	nature
gods	nature
goes	nature
golden	nature
golf	infrastructure_transport
golfer	athletics
gomez	nature
gone	nature
gonz	politics
goodwin	nature
goose	nature
gorge	nature
gorgeous	nature
gospels	nature
gothic	architecture
gotten	nature
gould	nature
gov	politics
govern	politics
governance	politics
governing	politics
government	politics
governmental	politics
governments	politics
governor	politics
governorate	politics
governors	politics
governorship	politics
gps	infrastructure_transport
grab	nature
grabbed	nature
grabs	nature
grace	nature
grade	architecture
graded	infrastructure_transport
grades	infrastructure_transport
gradient	nature
grading	infrastructure_transport
gradual	nature
grains	nature
gram	politics
grams	nature
grande	nature
granite	architecture
grape	nature
grapes	nature
graph	nature
graphical	video_game
graphics	video_game
grass	nature
grasses	nature
grassland	nature
grasslands	nature
grassy	nature
gravel	nature
graveyard	architecture
gravitational	nature
gravity	nature
gray	nature
grazing	nature
greater	nature
greatest	nature
greeks	politics
green	nature
greene	nature
greenish	nature
greenland	nature
greens	politics
greenville	nature
greeted	nature
greeting	nature
gregg	nature
grey	nature
greyish	nature
grid	infrastructure_transport
grievances	politics
griffin	nature
grocery	economics
grooves	nature
grossed	film
grossing	film
groundbreaking	infrastructure_transport
grounds	architecture
groundwater	nature
grouped	nature
groupings	politics
groups	politics
groves	nature
grow	nature
growing	nature
grown	nature
grows	nature
gt	war
guadalupe	nature
gubernatorial	politics
guerrero	nature
guess	nature
guests	nature
guiana	nature
guinea	nature
guitars	politics
gulf	nature
gum	nature
gunner	war
gunnery	war
gunshot	nature
gut	nature
guyana	nature
gymnasium	architecture
habit	nature
habitat	nature
habitation	nature
habitats	nature
habits	nature
habsburg	politics
hack	infrastructure_transport
hail	nature
hair	nature
haired	nature
hairs	nature
hairy	nature
hale	nature
half	nature
halfway	nature
hall	architecture
halls	architecture
halt	infrastructure_transport
halted	infrastructure_transport
halves	nature
hamilton	nature
hamlets	politics
hammond	nature
hampered	infrastructure_transport
hampshire	nature
hampson	nature
hampton	nature
hancock	nature
handful	nature
handle	infrastructure_transport
handles	politics
handling	infrastructure_transport
hang	nature
hangar	architecture
hanging	nature
hangs	infrastructure_transport
hank	nature
hannah	nature
happens	nature
harassment	politics
harbour	infrastructure_transport
harder	nature
hardest	nature
hardly	nature
hardwood	nature
hardy	nature
hare	nature
harlem	nature
harm	nature
harmful	nature
harmless	nature
harmonies	music
harris	nature
harsh	politics
harvest	nature
harvested	nature
harvesting	nature
hasn	nature
hat	nature
hatch	infrastructure_transport
hates	nature
hatred	politics
hauled	infrastructure_transport
haven	nature
hawaii	nature
hawaiian	nature
hawk	infrastructure_transport
hawker	infrastructure_transport
hawthorn	nature
hayes	nature
hazardous	infrastructure_transport
hazel	nature
hbo	film
hd	film
heading	nature
headlining	music
headquartered	politics
heads	nature
headwaters	nature
healed	nature
healing	nature
healthcare	economics
healthy	nature
hearings	politics
hears	nature
heart	nature
heartland	nature
heat	nature
heath	nature
heather	nature
heating	architecture
heavenly	nature
heavier	infrastructure_transport
heaviest	nature
hectare	architecture
hedge	nature
height	nature
heights	nature
heir	politics
helena	nature
helens	nature
helicopters	infrastructure_transport
helmet	infrastructure_transport
helpful	nature
hemisphere	nature
hen	nature
hence	nature
herb	nature
herbaceous	nature
herbs	nature
hercules	infrastructure_transport
herd	nature
here	nature
hereditary	politics
heritage	architecture
hermit	nature
hermitage	architecture
heroin	nature
heroism	war
heron	nature
herring	nature
hi	politics
hidalgo	nature
hidden	infrastructure_transport
hide	nature
hideout	nature
hides	nature
hiding	nature
higher	nature
highest	nature
highland	nature
highlands	nature
highlighted	nature
highs	nature
highway	infrastructure_transport
hike	nature
hiking	nature
hill	nature
hillary	nature
hills	nature
hilltop	nature
hilly	nature
himalayan	nature
himalayas	nature
hind	nature
hindered	infrastructure_transport
hinduism	nature
hindus	nature
hindwings	nature
hint	nature
hipped	architecture
hire	infrastructure_transport
hispanic	nature
historic	architecture
historically	nature
hitchcock	nature
hitter	athletics
hms	infrastructure_transport
holden	infrastructure_transport
holdings	economics
holes	infrastructure_transport
hollow	nature
holly	nature
holmes	nature
holotype	nature
home	nature
homeland	politics
homeless	nature
homer	nature
homes	architecture
homestead	architecture
homogeneous	nature
homosexuality	politics
honey	nature
honolulu	nature
hook	nature
hooked	nature
hooker	nature
hooks	nature
hop	nature
hopefully	nature
hopkins	nature
hopper	nature
horizon	nature
horizontal	infrastructure_transport
horizontally	nature
hormone	nature
horn	nature
horns	nature
horrified	nature
horror	film
horseback	nature
horsepower	infrastructure_transport
horses	nature
horseshoe	nature
horticultural	nature
horticulture	nature
horton	nature
hospitalized	politics
host	nature
hostel	architecture
hostile	politics
hostility	politics
hosts	nature
hot	nature
hotel	architecture
hotels	economics
hotspur	infrastructure_transport
hottest	nature
houghton	nature
hourly	infrastructure_transport
house	architecture
housed	architecture
householder	nature
houses	architecture
housing	architecture
houston	nature
howe	nature
however	nature
hp	infrastructure_transport
hr	politics
hubbard	nature
hudson	nature
hulk	infrastructure_transport
hull	infrastructure_transport
humanist	politics
humanitarian	politics
humans	nature
humboldt	nature
hume	nature
humid	nature
humidity	nature
hundred	nature
hundreds	nature
hungarians	politics
hungry	nature
hunt	nature
hunted	nature
hunter	nature
hunters	nature
hunting	nature
huntington	nature
hurdles	athletics
hurling	athletics
huron	nature
hurricane	nature
hurricanes	nature
hut	nature
hutchinson	nature
huts	architecture
hybrid	nature
hybrids	nature
hyde	nature
hydrogen	infrastructure_transport
hymns	music
hypotheses	nature
hypothesis	nature
hypothesized	nature
hypothetical	infrastructure_transport
iaaf	athletics
iberian	nature
ibm	politics
ibn	politics
ibrahim	politics
ice	nature
icon	infrastructure_transport
iconic	infrastructure_transport
icons	infrastructure_transport
idaho	nature
ideal	nature
ideally	nature
ideals	politics
identical	infrastructure_transport
identifiable	nature
identification	nature
identified	nature
identifier	infrastructure_transport
identifies	nature
identify	nature
ideological	politics
ideologies	politics
ideology	politics
idols	nature
ieee	politics
if	nature
ign	video_game
ignition	war
ignorance	politics
igor	politics
iii	infrastructure_transport
ik	politics
illegitimate	politics
illnesses	nature
illuminated	infrastructure_transport
illumination	infrastructure_transport
illustrates	infrastructure_transport
im	politics
imaging	politics
imitation	infrastructure_transport
immature	nature
immersion	nature
immigration	politics
immortality	nature
immunity	politics
impacted	infrastructure_transport
impacts	nature
impaired	infrastructure_transport
impairment	nature
imperialism	politics
implementations	infrastructure_transport
implemented	infrastructure_transport
implicated	politics
implication	nature
implies	nature
imply	nature
implying	nature
imported	infrastructure_transport
importing	economics
imports	economics
impose	politics
imposing	architecture
impractical	infrastructure_transport
impressive	nature
imprisoned	politics
imprisonment	politics
improved	infrastructure_transport
improvements	infrastructure_transport
improves	nature
ina	politics
inaccessible	nature
inaccurate	nature
inch	infrastructure_transport
inches	nature
incidence	nature
incidentally	nature
include	infrastructure_transport
includes	nature
incoming	nature
incomplete	infrastructure_transport
inconsistent	nature
incorporated	economics
incorporates	infrastructure_transport
incorporating	infrastructure_transport
incorrectly	nature
increases	nature
incredible	nature
incredibly	infrastructure_transport
incumbent	politics
incurred	infrastructure_transport
indeed	nature
indefinitely	infrastructure_transport
independence	politics
indexed	politics
indians	nature
indicate	nature
indicated	nature
indicates	nature
indicating	nature
indication	nature
indications	nature
indicative	nature
indicator	nature
indicators	nature
indictment	politics
indies	nature
indigenous	nature
individual	nature
individually	infrastructure_transport
individuals	nature
indo	nature
indoor	athletics
indoors	nature
induce	nature
induced	nature
inducing	nature
induction	nature
industries	economics
industry	economics
indy	infrastructure_transport
infant	nature
infantry	war
infants	nature
infected	nature
infection	nature
infections	nature
infectious	nature
inferior	infrastructure_transport
inferred	nature
infirmary	architecture
inflammation	nature
inflammatory	nature
inflated	infrastructure_transport
inflorescence	nature
influence	politics
informally	nature
informs	infrastructure_transport
infrared	nature
ingredient	nature
ingredients	nature
inhabit	nature
inhabited	nature
inhabiting	nature
inhabits	nature
inhibit	nature
inhibition	nature
injected	nature
injustice	politics
inland	nature
inlet	nature
inline	infrastructure_transport
inmate	nature
inn	architecture
inner	nature
innings	athletics
inorganic	nature
inputs	nature
inquiry	politics
ins	infrastructure_transport
inscriptions	architecture
insect	nature
insects	nature
inserted	infrastructure_transport
insertion	infrastructure_transport
insists	nature
inspection	infrastructure_transport
instability	politics
installed	architecture
installment	film
installments	video_game
instances	infrastructure_transport
instantly	nature
insurance	economics
insurgency	politics
insurrection	politics
intact	architecture
intake	nature
integer	nature
integration	politics
intel	politics
intellectual	politics
intellectuals	politics
intelligence	politics
intended	infrastructure_transport
intense	nature
intensified	politics
intensity	nature
intentional	nature
intentionally	infrastructure_transport
interact	film
interaction	nature
interactions	nature
interchangeable	infrastructure_transport
interconnected	infrastructure_transport
intercourse	nature
interdisciplinary	politics
interestingly	nature
interfaces	infrastructure_transport
interference	politics
interim	politics
interior	architecture
interiors	architecture
intermediate	nature
intermittent	nature
internal	politics
internally	infrastructure_transport
internationals	athletics
intersect	infrastructure_transport
intersecting	nature
intersection	infrastructure_transport
intersections	infrastructure_transport
intersects	nature
interstate	infrastructure_transport
interval	nature
intervals	nature
intervene	politics
intervention	politics
intimidation	politics
intricate	infrastructure_transport
intrinsic	nature
introduced	infrastructure_transport
introductory	infrastructure_transport
invalid	nature
invariably	nature
invasion	war
invasive	nature
invented	economics
inventory	architecture
inverse	nature
invertebrates	nature
inverted	infrastructure_transport
invest	economics
invested	economics
investigators	nature
investing	economics
investment	economics
investments	economics
investor	economics
investors	economics
invitational	athletics
invites	nature
involve	infrastructure_transport
involvement	politics
involves	infrastructure_transport
inward	nature
ion	politics
ionic	infrastructure_transport
ions	nature
ios	video_game
ipswich	infrastructure_transport
iris	nature
irregular	nature
irrigation	politics
irvine	nature
irwin	nature
isa	politics
isaac	nature
isaiah	nature
isfahan	architecture
islam	politics
islamic	politics
islamist	politics
island	nature
islander	nature
islanders	nature
islands	nature
isles	nature
isn	nature
isolate	nature
isolated	nature
isolation	nature
issue	politics
issues	politics
istat	politics
italianate	architecture
italics	nature
item	infrastructure_transport
items	infrastructure_transport
iteration	infrastructure_transport
itv	film
iucn	nature
ivy	nature
ja	politics
jade	nature
jaguar	infrastructure_transport
jailed	politics
jam	politics
jams	nature
janata	politics
jarvis	nature
jasper	nature
java	nature
jaw	nature
jaws	nature
jays	nature
jenkins	nature
jennings	nature
jenny	nature
jensen	nature
jersey	nature
jesse	nature
jesus	nature
jets	nature
jew	politics
jewel	nature
jewelry	economics
jewels	infrastructure_transport
jews	politics
johns	nature
joins	nature
joints	infrastructure_transport
josephine	nature
journalist	politics
journalistic	politics
judaism	politics
judge	politics
judged	infrastructure_transport
judging	nature
judicial	politics
judiciary	politics
judith	nature
judy	nature
jump	nature
jumped	nature
jumping	nature
jumps	nature
junctions	war
jungle	nature
juniors	athletics
junk	nature
junta	politics
jupiter	infrastructure_transport
jurassic	nature
juris	politics
jurisprudence	politics
jurist	politics
just	nature
justice	politics
justices	politics
justifyscalemajor	nature
juvenile	nature
juveniles	nature
kangaroo	nature
kansas	nature
katie	nature
katy	nature
kazakhstan	politics
keel	infrastructure_transport
keeps	nature
kenny	nature
kerman	politics
kern	nature
kernel	infrastructure_transport
keys	nature
keystone	infrastructure_transport
kh	politics
khorasan	nature
khz	infrastructure_transport
kicks	nature
kidney	nature
kilda	nature
kilkenny	nature
kill	nature
killers	nature
kilograms	nature
kilometer	nature
kilometers	nature
kilometres	nature
kimberley	nature
kingdoms	video_game
kirby	nature
kirk	infrastructure_transport
kissing	nature
kit	infrastructure_transport
kitchen	architecture
kits	infrastructure_transport
km	nature
knees	nature
knighted	politics
knock	nature
knocked	nature
knocking	nature
knockout	nature
knocks	nature
knot	nature
knots	infrastructure_transport
known	nature
knows	nature
konstantin	politics
kosovo	politics
krak	infrastructure_transport
kuala	nature
kurdish	politics
kurdistan	politics
kuyavian	nature
kw	infrastructure_transport
kyle	nature
kyrgyzstan	politics
labeled	nature
labelled	infrastructure_transport
labels	economics
labor	politics
labour	politics
labourers	politics
labrador	nature
labs	politics
lac	nature
lacks	nature
ladder	nature
laden	nature
lady	infrastructure_transport
lagoon	nature
laguna	nature
laid	infrastructure_transport
lake	nature
lakes	nature
lama	nature
lamar	nature
lamp	architecture
lamps	architecture
land	nature
landings	war
landlords	politics
landmark	architecture
landmarks	architecture
landowner	politics
landowners	politics
landscape	nature
landscaped	architecture
landscapes	nature
landscaping	architecture
landslide	politics
lane	infrastructure_transport
lanes	infrastructure_transport
langley	infrastructure_transport
lap	nature
laps	nature
laptop	infrastructure_transport
large	nature
larva	nature
larvae	nature
las	infrastructure_transport
lastly	nature
lasts	nature
lately	nature
lateral	nature
latitude	nature
latter	nature
lattice	infrastructure_transport
lauderdale	nature
launch	infrastructure_transport
launches	war
laureate	politics
laurel	nature
lauren	nature
lava	nature
lavish	architecture
law	politics
lawrence	nature
laws	politics
lawyer	politics
layer	nature
layered	nature
layers	nature
laying	infrastructure_transport
lays	nature
lbs	nature
lea	nature
leader	politics
leaders	politics
leadership	politics
leads	nature
leaf	nature
leaflets	politics
leafs	nature
league	athletics
leak	infrastructure_transport
leap	nature
learns	nature
lease	economics
leases	economics
leasing	economics
least	nature
leaves	nature
leftist	politics
legal	politics
legality	politics
legend	infrastructure_transport
legged	nature
legislation	politics
legislative	politics
legislator	politics
legislators	politics
legislature	politics
legislatures	politics
legitimacy	politics
legs	nature
lemon	nature
lending	economics
lends	nature
length	nature
lengthened	infrastructure_transport
lengths	nature
lenin	politics
leningrad	politics
leopard	nature
lesions	nature
less	nature
lesser	nature
lethal	nature
lettering	infrastructure_transport
letterman	nature
leukemia	nature
lev	politics
level	nature
lgbt	politics
liaison	politics
libel	politics
liberal	politics
liberalism	politics
liberals	politics
liberation	politics
liberia	nature
libertarian	politics
liberties	politics
library	architecture
libya	politics
licensed	politics
licenses	economics
licensing	economics
lid	infrastructure_transport
lie	nature
lies	nature
lieutenant	war
lifespan	nature
lifestyles	nature
lift	infrastructure_transport
lifted	infrastructure_transport
lifting	infrastructure_transport
lifts	infrastructure_transport
liga	athletics
ligament	nature
light	infrastructure_transport
lighter	infrastructure_transport
lighthouse	architecture
lightly	nature
lightning	nature
ligue	athletics
likelihood	nature
likely	nature
likened	nature
likeness	infrastructure_transport
likes	nature
likewise	nature
liking	nature
lil	politics
lily	nature
limb	nature
limbs	nature
lime	nature
limestone	architecture
limit	infrastructure_transport
limitation	infrastructure_transport
limitations	infrastructure_transport
limited	economics
limiting	infrastructure_transport
lincoln	nature
linda	nature
linden	infrastructure_transport
line	infrastructure_transport
lineage	nature
linear	nature
linebacker	athletics
lined	nature
liner	infrastructure_transport
lines	infrastructure_transport
linguistic	politics
lining	nature
link	infrastructure_transport
linked	infrastructure_transport
linking	infrastructure_transport
linux	politics
lion	nature
lip	nature
lips	nature
liquid	nature
liquidation	economics
liquor	economics
list	infrastructure_transport
listed	architecture
listing	infrastructure_transport
literacy	politics
literal	nature
litre	infrastructure_transport
litter	nature
little	nature
livelihood	politics
liver	nature
livery	infrastructure_transport
livestock	nature
living	nature
livingston	nature
lix	politics
lizard	nature
lizards	nature
llc	politics
load	infrastructure_transport
loaded	infrastructure_transport
loading	infrastructure_transport
loads	infrastructure_transport
loans	economics
lobe	nature
lobes	nature
localities	nature
locality	nature
localized	nature
locally	nature
locals	nature
location	architecture
locations	infrastructure_transport
loch	nature
lock	infrastructure_transport
locked	infrastructure_transport
locker	infrastructure_transport
locking	infrastructure_transport
locks	infrastructure_transport
locomotive	infrastructure_transport
locomotives	infrastructure_transport
lodge	architecture
lodged	architecture
lodging	architecture
loft	architecture
log	architecture
logan	nature
logged	nature
logos	politics
logs	infrastructure_transport
lok	politics
lombardy	nature
lone	nature
long	nature
longest	nature
longevity	nature
longitude	nature
longitudinal	nature
looked	nature
lookout	nature
looks	nature
loop	infrastructure_transport
loops	infrastructure_transport
lopez	nature
lords	politics
lordship	politics
lorenzo	infrastructure_transport
loser	nature
losers	nature
lotus	nature
lou	nature
louisa	nature
louisiana	nature
lounge	nature
louvre	architecture
lovely	nature
loving	nature
low	nature
lowe	nature
lowell	infrastructure_transport
lower	nature
lowered	infrastructure_transport
lowest	nature
lowland	nature
lowlands	nature
loyal	politics
loyalist	politics
loyalists	politics
loyalty	politics
lt	war
lucia	nature
lucrative	economics
lucy	nature
luftwaffe	war
luggage	infrastructure_transport
luigi	infrastructure_transport
luke	nature
lumber	economics
lunch	nature
lungs	nature
lure	nature
lured	nature
lush	nature
luther	nature
luxurious	infrastructure_transport
luxury	politics
luzon	nature
lying	nature
lyric	music
lyrics	music
macedonian	politics
machines	infrastructure_transport
mack	nature
macquarie	nature
madagascar	nature
madeira	nature
madhya	politics
madonna	nature
mag	politics
magazines	economics
magdalena	nature
maggie	nature
magistrate	politics
magnate	economics
magnesium	nature
magnet	nature
magnetic	nature
magnitude	nature
magnum	infrastructure_transport
maharashtra	politics
mailing	economics
main	infrastructure_transport
maine	nature
mainland	nature
maize	nature
majestic	infrastructure_transport
majority	politics
maker	economics
makers	economics
makes	nature
malaria	nature
malawi	nature
male	nature
males	nature
mall	infrastructure_transport
mammal	nature
mammalian	nature
mammals	nature
management	economics
managing	economics
mandal	politics
mandate	politics
mandates	politics
manga	film
manifesto	politics
manitoba	nature
manor	architecture
mansion	architecture
mansions	architecture
mantle	nature
manually	infrastructure_transport
manuals	infrastructure_transport
manufacture	economics
manufacturers	economics
manufactures	politics
manufacturing	economics
mao	politics
map	infrastructure_transport
maple	nature
mapped	nature
maps	infrastructure_transport
marble	architecture
margin	nature
margins	nature
mariana	nature
marijuana	nature
marilyn	nature
marine	infrastructure_transport
marino	infrastructure_transport
marital	politics
marked	infrastructure_transport
markedly	nature
marker	infrastructure_transport
markers	infrastructure_transport
market	economics
markets	economics
marking	infrastructure_transport
markings	nature
marks	nature
markus	politics
maroon	nature
marriage	politics
marry	politics
mars	infrastructure_transport
marsh	nature
marshes	nature
martha	nature
martina	nature
martyrs	infrastructure_transport
marxism	politics
marxist	politics
maryland	nature
mason	nature
masonic	architecture
masonry	architecture
masovian	politics
masses	politics
massif	nature
massively	infrastructure_transport
mastered	music
masts	infrastructure_transport
mata	nature
matched	nature
matches	athletics
matching	infrastructure_transport
mate	nature
mater	infrastructure_transport
materials	architecture
mates	nature
mating	nature
matters	politics
mature	nature
maturity	nature
mausoleum	architecture
maxim	politics
maximize	infrastructure_transport
maximum	nature
maybe	nature
maynard	nature
mayo	nature
mayor	politics
mayoral	politics
mayors	politics
mb	infrastructure_transport
mca	politics
mccartney	nature
mckinley	nature
mclaren	infrastructure_transport
mcmahon	nature
md	politics
mdash	nature
meadow	nature
meadows	nature
meal	nature
mean	nature
meaning	nature
meanings	politics
means	nature
meant	infrastructure_transport
measured	nature
measurements	nature
measures	nature
measuring	nature
meat	nature
mechanic	infrastructure_transport
mechanically	infrastructure_transport
mechanism	infrastructure_transport
mecklenburg	nature
med	politics
medallist	athletics
medial	nature
median	nature
mediate	politics
mediation	politics
medication	nature
medicinal	nature
medicines	politics
medieval	architecture
meditation	nature
mediterranean	nature
medium	infrastructure_transport
meet	infrastructure_transport
meets	nature
megan	nature
melanie	nature
melodies	music
melt	nature
melting	nature
membranes	nature
memorabilia	infrastructure_transport
memorial	infrastructure_transport
mentioning	infrastructure_transport
mercantile	economics
mercedes	infrastructure_transport
mercer	nature
merchandise	economics
merchants	economics
mercury	nature
mercy	nature
merged	economics
merger	economics
merges	nature
meridian	infrastructure_transport
mesa	nature
mesh	nature
messiah	nature
metabolic	nature
metabolism	nature
metallic	nature
metaphor	infrastructure_transport
meter	infrastructure_transport
meters	nature
method	infrastructure_transport
methyl	nature
metre	infrastructure_transport
metres	nature
mexico	nature
meyrick	nature
mfa	politics
mg	nature
mgm	film
miami	nature
mice	nature
michigan	nature
micro	politics
microphone	infrastructure_transport
microscopic	nature
microsoft	politics
microwave	politics
midday	nature
middle	nature
midfield	athletics
midfielder	athletics
midland	infrastructure_transport
midpoint	nature
midsummer	nature
midtown	infrastructure_transport
midwestern	nature
might	nature
migrant	nature
migrants	nature
migrate	nature
migrating	nature
migration	nature
migratory	nature
mild	nature
mile	infrastructure_transport
miles	nature
milford	nature
militant	politics
militants	politics
milk	nature
milky	nature
mill	architecture
millennia	nature
milling	economics
mimic	nature
minas	nature
minded	politics
mine	nature
mined	nature
mineral	nature
minerals	politics
miniature	infrastructure_transport
minimal	infrastructure_transport
minimize	infrastructure_transport
minimum	nature
mining	economics
miniseries	film
minister	politics
ministerial	politics
ministers	politics
ministry	politics
minnesota	nature
minor	nature
minorities	politics
minority	politics
mint	infrastructure_transport
minus	nature
minute	film
miocene	nature
miracles	nature
mirrors	infrastructure_transport
misses	nature
missile	infrastructure_transport
missiles	infrastructure_transport
missing	infrastructure_transport
mississippi	nature
missouri	nature
mist	nature
mistaken	nature
mitchell	nature
mitigate	infrastructure_transport
mitochondrial	nature
mixture	nature
mk	infrastructure_transport
mla	politics
mlb	nature
mm	nature
moat	architecture
mod	video_game
mode	video_game
model	infrastructure_transport
modeled	infrastructure_transport
modelled	infrastructure_transport
models	infrastructure_transport
moderate	politics
moderately	nature
modernist	architecture
modernized	infrastructure_transport
modes	video_game
modification	infrastructure_transport
modifications	infrastructure_transport
modified	infrastructure_transport
modify	infrastructure_transport
modifying	infrastructure_transport
module	infrastructure_transport
modules	infrastructure_transport
mohammad	politics
moist	nature
moisture	nature
moldova	politics
mole	nature
molecular	nature
molecule	nature
molecules	nature
mollusk	nature
mollusks	nature
molly	nature
moment	nature
mona	nature
monarch	infrastructure_transport
monarchs	nature
monarchy	politics
monastery	architecture
monastic	architecture
monde	politics
mongolia	nature
monitored	nature
monitors	infrastructure_transport
monk	nature
monkey	nature
monkeys	nature
mono	nature
monoplane	infrastructure_transport
monopoly	economics
monotypic	nature
monroe	nature
monsoon	nature
monstrous	nature
mont	nature
montana	nature
montane	nature
monte	nature
monterey	nature
monument	architecture
monumental	architecture
monuments	architecture
moon	nature
moonlight	nature
moor	nature
moore	nature
moors	nature
moose	nature
moral	politics
morality	politics
morals	politics
more	nature
mornings	nature
morphological	nature
morphology	nature
mortality	nature
mortgage	economics
moses	nature
mosque	architecture
mosques	architecture
mosquito	nature
moss	nature
most	nature
mostly	nature
motel	infrastructure_transport
moths	nature
motif	infrastructure_transport
motor	infrastructure_transport
motorcycle	infrastructure_transport
motorcycles	infrastructure_transport
motorized	infrastructure_transport
motors	economics
motorsports	politics
motorway	infrastructure_transport
mound	nature
mounds	nature
mount	nature
mountain	nature
mountainous	nature
mountains	nature
mounted	infrastructure_transport
mounting	infrastructure_transport
mounts	infrastructure_transport
mouse	nature
mouth	nature
mouths	nature
move	nature
movement	politics
movements	politics
moves	nature
movie	film
movies	film
mozambique	nature
mp	politics
mph	infrastructure_transport
mps	politics
msc	politics
mt	nature
mtv	film
mu	politics
much	nature
mud	nature
muddy	nature
mule	infrastructure_transport
multidisciplinary	politics
multimedia	politics
multiplayer	video_game
multiple	infrastructure_transport
multitude	nature
municipal	politics
municipality	politics
mural	architecture
murals	architecture
muscle	infrastructure_transport
muscles	infrastructure_transport
muscular	nature
museo	architecture
museum	architecture
mushroom	nature
musically	music
muslim	politics
muslims	politics
must	nature
mustafa	politics
mustard	nature
mustered	war
mutant	nature
mutation	nature
mutations	nature
mutiny	politics
muzzle	nature
myanmar	nature
myers	nature
myrtle	nature
mysterious	infrastructure_transport
mysteriously	nature
mystic	nature
mystical	nature
mythical	nature
mythology	infrastructure_transport
na	politics
naacp	politics
nad	politics
nadu	politics
nails	infrastructure_transport
naked	nature
named	nature
namely	nature
names	infrastructure_transport
namesake	nature
namibia	nature
naming	infrastructure_transport
napier	infrastructure_transport
narrated	film
narrates	film
narration	film
narrative	film
narrow	nature
narrowed	nature
narrower	nature
narrows	nature
nasal	nature
nascar	infrastructure_transport
nathaniel	nature
nationalism	politics
nationalist	politics
nationalists	politics
nationally	nature
native	nature
natives	nature
nato	politics
natural	nature
naturalist	nature
naturalized	nature
naturally	nature
nature	nature
nave	architecture
navigable	nature
navigation	infrastructure_transport
navigational	infrastructure_transport
navigator	infrastructure_transport
navy	infrastructure_transport
nazi	politics
nazis	politics
nbc	film
ncaa	athletics
near	nature
nearer	nature
nearest	nature
nearing	infrastructure_transport
nearly	nature
nebraska	nature
necessarily	nature
neck	nature
necklace	infrastructure_transport
nectar	nature
needing	infrastructure_transport
needle	nature
neglect	architecture
negligence	politics
negligible	nature
negotiation	politics
negotiations	politics
negro	nature
neighbor	nature
neighborhood	architecture
neighborhoods	nature
neighbors	nature
neighbour	nature
neighbouring	nature
neither	nature
nemesis	infrastructure_transport
nen	politics
neo	architecture
neoclassical	architecture
neolithic	nature
nepal	politics
neptune	nature
nerve	infrastructure_transport
nerves	nature
nervous	nature
nes	video_game
nest	nature
nesting	nature
nests	nature
net	nature
nets	nature
netting	nature
networking	politics
neurological	nature
neurons	nature
neuroscience	politics
neutrality	politics
nevada	nature
newborn	nature
newcomers	nature
newer	infrastructure_transport
newman	nature
newmarket	architecture
newspaper	politics
ngo	politics
ngos	politics
nh	nature
niagara	nature
nica	politics
niche	nature
nicholas	nature
nickel	nature
nickelodeon	film
nicknamed	infrastructure_transport
nicknames	nature
niger	nature
nighttime	infrastructure_transport
nikki	nature
nikolai	politics
nile	nature
nine	nature
ninety	nature
nintendo	video_game
ninth	nature
nippon	politics
nitrogen	nature
nl	politics
no	nature
nobility	politics
nobleman	politics
nobles	politics
noctuidae	nature
nocturnal	nature
nod	infrastructure_transport
node	nature
nodes	nature
noises	nature
noisy	nature
nolan	nature
nomadic	nature
nomenclature	nature
nominate	nature
nominations	film
none	nature
normalized	nature
normally	nature
norse	nature
norte	nature
north	nature
northbound	infrastructure_transport
northeast	nature
northeastern	nature
northerly	nature
northern	nature
northernmost	nature
northward	nature
northwards	nature
northwest	nature
northwestern	nature
norwood	nature
nose	nature
notation	infrastructure_transport
notch	nature
note	nature
noted	nature
notes	nature
noteworthy	infrastructure_transport
noticeable	nature
noticeably	nature
notices	nature
noting	nature
notoriously	nature
noun	infrastructure_transport
nouveau	architecture
novi	politics
novice	nature
nowhere	nature
nude	nature
null	nature
number	nature
numbered	infrastructure_transport
numbering	infrastructure_transport
numbers	nature
nut	nature
nutrient	nature
nutrients	nature
nutritional	nature
nuts	nature
nw	architecture
oakland	nature
oaks	nature
oasis	nature
oath	politics
oaxaca	nature
obama	politics
obec	politics
obedience	politics
object	infrastructure_transport
objectives	politics
oblast	politics
obligation	politics
obligations	politics
oblique	nature
oblong	nature
obscure	nature
observance	politics
observations	nature
observatory	architecture
observe	nature
observed	nature
observes	nature
observing	nature
obsolete	infrastructure_transport
obstacle	infrastructure_transport
obtains	infrastructure_transport
obvious	nature
obviously	nature
occasionally	nature
occupancy	architecture
occupies	infrastructure_transport
occur	nature
occurrence	nature
occurrences	nature
occurring	nature
occurs	nature
ocean	nature
oceania	nature
oceanic	nature
oceans	nature
ochreous	nature
octagonal	architecture
octave	nature
offended	politics
offenders	nature
offering	economics
offices	economics
officiated	athletics
offseason	nature
offset	infrastructure_transport
offshore	politics
offspring	nature
ohio	nature
oil	economics
ois	politics
ol	nature
ola	politics
olive	nature
olivia	nature
olympian	athletics
om	politics
omega	nature
omitted	infrastructure_transport
onboard	infrastructure_transport
once	nature
ones	nature
oneself	nature
only	nature
onlyinclude	nature
ontario	nature
opening	infrastructure_transport
openings	infrastructure_transport
openly	politics
operate	economics
operates	politics
operating	economics
operational	infrastructure_transport
operators	economics
opined	nature
opinions	politics
oppose	politics
opposed	politics
opposes	politics
opposing	politics
opposition	politics
oppressed	politics
oppression	politics
oppressive	politics
optimal	nature
optimized	infrastructure_transport
optional	infrastructure_transport
options	infrastructure_transport
opus	politics
oral	nature
orange	nature
oratory	architecture
orbit	nature
orbital	nature
orbiting	nature
orbits	nature
orchard	infrastructure_transport
orchards	nature
orchestra	music
orchid	nature
ordinance	politics
ore	nature
organic	nature
organisation	politics
organise	politics
organiser	politics
organises	politics
organising	politics
organism	nature
organisms	nature
organize	politics
organizer	politics
organizes	politics
organizing	politics
ori	politics
orientation	nature
origin	nature
originality	nature
originally	infrastructure_transport
originate	nature
originated	nature
originates	nature
originating	nature
orioles	nature
orleans	nature
ornamental	nature
ornamentation	architecture
ornaments	architecture
ornate	architecture
orphanage	architecture
orthodox	politics
orthodoxy	politics
otherwise	nature
otter	nature
ottoman	politics
ottomans	politics
ousted	politics
outbreak	war
outdated	infrastructure_transport
outdoors	nature
outer	infrastructure_transport
outfield	athletics
outfielder	athletics
outflow	nature
outlets	economics
outlined	infrastructure_transport
outlook	politics
outlying	nature
output	infrastructure_transport
outputs	nature
outscored	athletics
outspoken	politics
outward	nature
oval	nature
oven	architecture
overall	nature
overdose	nature
overhaul	infrastructure_transport
overhead	infrastructure_transport
overland	nature
overlap	nature
overlapping	nature
overlooked	nature
overlooking	architecture
overlooks	nature
overnight	nature
overrun	war
oversees	politics
overthrow	politics
overthrown	politics
owens	nature
owl	nature
owls	nature
owned	economics
owner	economics
owners	economics
ownership	economics
owning	economics
ox	infrastructure_transport
oxidation	nature
oxide	infrastructure_transport
oxygen	nature
oyster	nature
pace	nature
paced	nature
pacific	nature
package	infrastructure_transport
packages	infrastructure_transport
packaging	politics
packard	infrastructure_transport
packed	nature
packet	infrastructure_transport
pact	politics
pad	infrastructure_transport
paddle	infrastructure_transport
paddy	nature
padres	nature
pads	infrastructure_transport
painful	nature
pair	infrastructure_transport
pairs	nature
palace	architecture
palaces	architecture
palais	architecture
palatinate	nature
palazzo	architecture
pale	nature
paler	nature
palestine	politics
palm	nature
palma	nature
palmer	nature
palms	nature
pamphlet	politics
pamphlets	politics
panama	nature
panchayat	politics
panic	nature
panorama	film
panoramic	nature
panther	nature
panthers	nature
pants	nature
papacy	politics
papua	nature
paradise	nature
paraguay	nature
parallel	infrastructure_transport
parallels	nature
parameter	infrastructure_transport
parameters	infrastructure_transport
paramilitary	politics
paran	nature
parapet	architecture
parasite	nature
parasites	nature
parasitic	nature
parc	infrastructure_transport
parcel	architecture
parcels	economics
pardon	politics
pardoned	politics
parentheses	war
parish	architecture
parishioners	architecture
park	infrastructure_transport
parked	infrastructure_transport
parker	nature
parking	infrastructure_transport
parkland	architecture
parks	infrastructure_transport
parkway	infrastructure_transport
parliament	politics
parliamentarian	politics
parliamentary	politics
parochial	architecture
parodies	film
parody	film
parsons	nature
partial	infrastructure_transport
partially	infrastructure_transport
participants	nature
particle	nature
particles	nature
parties	politics
partisan	politics
partition	politics
partner	economics
partnered	economics
partnering	economics
partners	economics
partnership	economics
partnerships	economics
parts	nature
party	politics
pasadena	nature
pasha	politics
paso	nature
pass	nature
passage	nature
passenger	infrastructure_transport
passengers	infrastructure_transport
passes	nature
passing	nature
past	nature
pasture	nature
pastures	nature
patch	infrastructure_transport
patches	nature
patent	economics
patents	economics
paterson	nature
path	nature
pathogen	nature
paths	nature
pathway	nature
pathways	nature
patient	nature
patriarch	politics
patriotism	politics
patriots	politics
patrolling	war
patrols	war
patrons	nature
patterned	infrastructure_transport
patterns	nature
patti	nature
patty	nature
paved	infrastructure_transport
pavel	politics
pavement	infrastructure_transport
pavilion	architecture
paving	infrastructure_transport
payne	nature
pbs	film
pc	video_game
peace	politics
peaceful	politics
peacefully	politics
peacekeeping	politics
peach	nature
peacock	nature
peak	nature
peaked	music
peaks	nature
pearl	nature
peasant	politics
peasants	politics
peat	nature
peculiar	nature
pedestrian	infrastructure_transport
pedestrians	infrastructure_transport
peel	nature
peerage	politics
penal	politics
penetrate	nature
penetrated	nature
penetrating	nature
penguins	nature
peninsula	nature
penn	infrastructure_transport
pennant	infrastructure_transport
pensacola	infrastructure_transport
pensions	politics
penultimate	nature
peoples	politics
pepper	nature
peppers	nature
perceived	politics
percentage	nature
perch	nature
perennial	nature
perfection	nature
perfectly	nature
perhaps	nature
perimeter	infrastructure_transport
periodicals	economics
periods	nature
periphery	nature
perished	war
perkins	infrastructure_transport
permitted	infrastructure_transport
perpendicular	infrastructure_transport
persecuted	politics
persecution	politics
persist	nature
persistent	nature
person	nature
perspectives	politics
perth	infrastructure_transport
peru	nature
pest	nature
pet	nature
petals	nature
pete	nature
peterborough	nature
peters	nature
petition	politics
petitions	politics
petrol	infrastructure_transport
petroleum	economics
pets	nature
pharmaceutical	politics
pharmacy	economics
phase	infrastructure_transport
phased	infrastructure_transport
phases	architecture
phenomena	nature
phenomenon	nature
philips	politics
phone	infrastructure_transport
phones	infrastructure_transport
phosphate	nature
phylogenetic	nature
physically	nature
physiological	nature
physiology	nature
piazza	architecture
pick	nature
picking	nature
picks	nature
picnic	nature
pictured	infrastructure_transport
picturesque	nature
piedmont	nature
pier	infrastructure_transport
pierce	nature
pierced	infrastructure_transport
piercing	nature
pig	nature
pigeon	nature
pigs	nature
pike	nature
pilasters	architecture
pilgrimage	nature
pilgrims	nature
pillar	infrastructure_transport
pillars	infrastructure_transport
pills	nature
piloted	infrastructure_transport
pilots	war
pine	nature
pines	nature
pink	nature
pinnacle	nature
pioneered	economics
piper	infrastructure_transport
pistol	infrastructure_transport
pistols	infrastructure_transport
piston	infrastructure_transport
pit	infrastructure_transport
pitcher	nature
pitchers	nature
pitching	video_game
pits	infrastructure_transport
pitted	nature
placed	infrastructure_transport
placement	nature
places	architecture
plague	nature
plagued	infrastructure_transport
plain	nature
plains	nature
planes	infrastructure_transport
planet	nature
planets	nature
planned	infrastructure_transport
plant	nature
plantation	architecture
planted	nature
planting	nature
plants	nature
plaques	infrastructure_transport
plaster	architecture
plastics	politics
plate	infrastructure_transport
plateau	nature
plates	infrastructure_transport
platform	infrastructure_transport
platforms	video_game
platted	politics
playable	video_game
playback	film
player	video_game
players	video_game
playground	infrastructure_transport
playstation	video_game
plaza	architecture
pleas	politics
pleasant	nature
pleasure	nature
pledge	politics
pleistocene	nature
plentiful	nature
plenty	nature
plot	film
plum	nature
plumbing	architecture
plurality	politics
plymouth	infrastructure_transport
pocket	infrastructure_transport
pockets	nature
pod	infrastructure_transport
podium	nature
podlaskie	nature
point	nature
pointe	nature
pointed	nature
pointing	nature
poison	nature
poisoned	nature
poisoning	nature
poisonous	nature
polar	nature
pole	nature
poles	nature
policies	politics
policing	politics
policy	politics
political	politics
politically	politics
politician	politics
politicians	politics
politics	politics
pollen	nature
pollution	nature
polly	nature
pomerania	politics
pomeranian	politics
pond	nature
ponds	nature
pont	infrastructure_transport
pony	nature
pool	infrastructure_transport
pools	nature
poorer	nature
poorest	nature
poorly	nature
pops	nature
populace	politics
populated	nature
populations	nature
populist	politics
porch	architecture
porsche	infrastructure_transport
port	infrastructure_transport
portable	infrastructure_transport
portal	infrastructure_transport
porte	infrastructure_transport
ported	video_game
portfolio	economics
portico	architecture
portray	film
portrayal	film
portrayed	film
portraying	film
ports	infrastructure_transport
pose	nature
poses	nature
position	politics
positioned	infrastructure_transport
positioning	infrastructure_transport
positions	politics
possess	nature
possesses	nature
possessing	nature
possible	nature
possibly	nature
posterior	nature
posts	politics
posture	nature
pot	nature
potassium	nature
potato	nature
potatoes	nature
potent	nature
potential	nature
potentially	nature
potomac	nature
pots	nature
pound	infrastructure_transport
pounder	infrastructure_transport
pow	war
powder	nature
powered	infrastructure_transport
powerhouse	infrastructure_transport
pradesh	politics
pragmatic	politics
prairie	nature
pratt	nature
pray	nature
prayed	nature
praying	nature
pre	infrastructure_transport
precious	nature
precipitation	nature
precise	nature
precisely	nature
precursor	infrastructure_transport
precursors	infrastructure_transport
predator	nature
predators	nature
predatory	nature
predecessor	infrastructure_transport
predecessors	infrastructure_transport
predict	infrastructure_transport
predicted	nature
predicting	infrastructure_transport
predominant	nature
predominantly	nature
prefect	politics
prefer	nature
preference	nature
preferences	nature
preferred	nature
prefers	nature
prefix	infrastructure_transport
pregnancy	nature
pregnant	nature
prehistoric	nature
prelate	politics
preliminary	nature
prematurely	nature
premiere	film
premiered	film
premiership	athletics
premise	film
premises	architecture
premium	infrastructure_transport
preparatory	architecture
prepares	nature
presbyterian	architecture
presence	nature
presenters	film
presently	politics
preservation	architecture
preserved	architecture
preserves	architecture
presidency	politics
presidential	politics
presiding	politics
presses	economics
presumed	nature
pretext	politics
pretty	nature
prevalence	nature
prevalent	nature
prevents	nature
preview	film
previous	infrastructure_transport
prey	nature
pri	politics
price	infrastructure_transport
priced	infrastructure_transport
pricing	infrastructure_transport
pride	nature
primaries	politics
primate	nature
primetime	film
primitive	nature
principality	politics
printer	economics
printers	economics
printing	economics
priority	nature
priory	architecture
prisoner	war
privately	economics
privileges	politics
privy	politics
prized	nature
probability	nature
probable	nature
problem	nature
problematic	nature
proceed	infrastructure_transport
proceeding	nature
proceedings	politics
processed	nature
processing	economics
procession	nature
proclamation	politics
procured	infrastructure_transport
produced	film
producing	economics
product	politics
production	economics
productions	economics
products	economics
profession	politics
professions	politics
profitable	economics
profits	economics
programming	film
progression	nature
progressive	politics
prohibit	infrastructure_transport
prohibits	nature
project	infrastructure_transport
projected	infrastructure_transport
projecting	nature
projections	nature
promenade	infrastructure_transport
promoters	economics
promotes	politics
prone	nature
propagated	nature
propagation	nature
propeller	infrastructure_transport
propellers	infrastructure_transport
properties	architecture
property	architecture
prophet	nature
prophets	nature
proportion	nature
proportional	nature
proportions	nature
proposed	infrastructure_transport
proprietary	politics
proprietor	economics
prosecute	politics
prosecuted	politics
prosecuting	politics
prosecution	politics
prosecutor	politics
prospect	nature
prospered	economics
prosperity	politics
prostitute	infrastructure_transport
protagonists	film
protectorate	politics
protects	nature
protest	politics
protestant	politics
protestants	politics
protested	politics
protesters	politics
protesting	politics
protests	politics
proto	infrastructure_transport
proton	infrastructure_transport
prototype	infrastructure_transport
prototypes	infrastructure_transport
protracted	politics
protruding	nature
proves	nature
provides	nature
provinces	nature
provincial	politics
provisional	politics
provisions	politics
provoke	politics
provoked	politics
proximity	nature
prussia	politics
prussian	politics
ps	infrastructure_transport
pseudo	infrastructure_transport
psychiatry	politics
pu	politics
publications	economics
publisher	economics
publishers	economics
publishes	politics
publishing	economics
pubs	economics
puerto	nature
pulitzer	nature
pulled	infrastructure_transport
pulling	nature
pulls	nature
pulmonate	nature
pulp	politics
pulpit	architecture
pulse	nature
pump	infrastructure_transport
pumped	infrastructure_transport
punt	nature
pupil	nature
purchase	economics
purchased	economics
purchases	economics
purchasing	economics
pure	nature
purge	politics
purification	infrastructure_transport
purity	nature
purple	nature
purportedly	infrastructure_transport
purpose	infrastructure_transport
purse	infrastructure_transport
pursues	nature
pushes	nature
puts	nature
puzzles	video_game
pyramid	nature
python	nature
q	nature
qi	nature
quad	infrastructure_transport
qualities	nature
quantities	nature
quantity	nature
quantum	politics
quarrel	politics
quarry	architecture
quarterback	athletics
quarterfinal	nature
quarterfinals	nature
quartermaster	war
quarters	architecture
quartz	nature
quay	infrastructure_transport
quechua	nature
queens	nature
questionable	nature
quicker	infrastructure_transport
quite	nature
quiz	film
rabbi	politics
rabbit	nature
rabbits	nature
racer	video_game
racetrack	infrastructure_transport
raceway	nature
racial	politics
racism	politics
racist	politics
rack	infrastructure_transport
radar	infrastructure_transport
radcliffe	nature
radial	infrastructure_transport
radiation	nature
radical	politics
radicals	politics
radioactive	nature
raf	war
raft	nature
raging	nature
raid	war
raiders	nature
rail	infrastructure_transport
railroad	infrastructure_transport
rails	infrastructure_transport
railway	infrastructure_transport
railways	economics
rain	nature
rainbow	nature
rainfall	nature
rainforest	nature
rains	nature
rainy	nature
raion	politics
raises	nature
rajasthan	nature
rallied	politics
rallies	politics
rally	politics
rallying	politics
ramp	infrastructure_transport
rampant	nature
ramps	infrastructure_transport
ramsey	nature
randomly	nature
range	nature
ranged	nature
ranger	infrastructure_transport
ranges	nature
ranging	nature
rapids	nature
rare	nature
rarely	nature
rarity	nature
ras	politics
rat	nature
rate	nature
rated	nature
rates	nature
rather	nature
ratification	politics
ratings	film
ratio	nature
ratios	nature
rats	nature
ravens	nature
ray	nature
rays	nature
razed	architecture
reach	nature
reaches	nature
reaching	nature
reactivated	infrastructure_transport
reacts	nature
readily	nature
readings	nature
reads	nature
ready	infrastructure_transport
realist	politics
realities	politics
reality	film
realization	nature
realize	nature
realizes	nature
really	nature
realms	video_game
reason	nature
reasonable	nature
reasonably	nature
rebecca	nature
rebel	politics
rebelled	politics
rebellion	politics
rebellions	politics
rebels	politics
rebound	nature
rebounds	athletics
rebranded	politics
rebuild	architecture
rebuilding	architecture
rebuilt	architecture
recalling	infrastructure_transport
receiver	infrastructure_transport
receivers	politics
receives	nature
recent	nature
receptors	nature
recessed	infrastructure_transport
recession	economics
reclaimed	architecture
reclamation	architecture
recognizable	nature
recognize	nature
recognized	nature
recognizes	nature
recommend	nature
recommends	nature
reconciliation	politics
reconnaissance	war
reconstruct	architecture
reconstructed	architecture
reconstruction	architecture
recorded	music
records	economics
recovers	nature
recreation	infrastructure_transport
recreational	nature
rectangular	architecture
rector	politics
rectory	architecture
recurring	film
recycled	infrastructure_transport
recycling	politics
red	nature
reddish	nature
redesign	infrastructure_transport
redesignated	infrastructure_transport
redesigned	infrastructure_transport
redeveloped	architecture
redevelopment	architecture
rediscovered	architecture
redistribution	politics
reduce	infrastructure_transport
reduced	infrastructure_transport
reduces	nature
reductions	infrastructure_transport
redundant	architecture
reed	nature
reef	nature
reefs	nature
reel	film
reelected	politics
reelection	politics
reference	infrastructure_transport
referenced	infrastructure_transport
referencing	infrastructure_transport
referendum	politics
referred	infrastructure_transport
referring	nature
refers	nature
refined	infrastructure_transport
refinery	economics
refining	economics
refit	infrastructure_transport
reflect	infrastructure_transport
reflective	nature
reform	politics
reformation	politics
reformer	politics
reformers	politics
reforms	politics
refuge	nature
refugees	politics
refurbished	architecture
refurbishment	architecture
regal	infrastructure_transport
regarded	nature
regardless	nature
regeneration	nature
reggie	nature
regime	politics
regiment	war
regiments	war
region	nature
regionally	nature
regions	nature
register	architecture
registered	economics
registers	architecture
registrar	politics
regulated	politics
regulators	politics
regulatory	politics
reich	politics
reigning	nature
reinforcements	war
reintroduced	infrastructure_transport
rejects	nature
related	infrastructure_transport
relations	politics
relative	nature
relatively	nature
relatives	nature
relaunched	economics
relax	nature
relegated	athletics
relegation	athletics
reliability	infrastructure_transport
reliably	nature
reliance	economics
reliant	infrastructure_transport
relic	infrastructure_transport
relics	architecture
reliefs	architecture
relies	infrastructure_transport
religion	politics
religions	politics
religious	politics
relocate	architecture
relocation	architecture
remade	film
remaining	nature
remains	nature
remake	film
remarkable	nature
remarkably	nature
remarked	nature
remarks	politics
remedy	nature
reminds	nature
reminiscent	infrastructure_transport
remnant	nature
remnants	nature
remodeled	architecture
remote	nature
remotely	infrastructure_transport
removes	nature
renaissance	architecture
rendezvous	nature
reno	nature
renounced	politics
renovate	architecture
renovated	architecture
renovation	architecture
renovations	architecture
rented	architecture
renumbered	infrastructure_transport
reopen	architecture
reopened	architecture
repaired	architecture
repairs	architecture
repeal	politics
repeated	nature
replace	infrastructure_transport
replaced	infrastructure_transport
replacement	infrastructure_transport
replacements	infrastructure_transport
replaces	infrastructure_transport
replacing	infrastructure_transport
replay	video_game
replication	infrastructure_transport
replies	nature
repository	infrastructure_transport
represent	nature
representative	politics
representatives	politics
represents	nature
repression	politics
reproduce	nature
reproduction	nature
reproductive	nature
reptiles	nature
republic	politics
republican	politics
republicans	politics
repulsed	war
requirement	infrastructure_transport
requires	nature
requiring	infrastructure_transport
rescues	nature
researchers	nature
resemblance	nature
resemble	nature
resembled	infrastructure_transport
resembles	nature
resentment	politics
reservation	nature
reservations	nature
reserved	infrastructure_transport
reservoir	architecture
reservoirs	architecture
reside	nature
residence	architecture
residences	architecture
resident	nature
residential	architecture
residents	nature
residue	nature
residues	nature
resign	politics
resignation	politics
resigned	politics
resigning	politics
resin	infrastructure_transport
resistance	politics
resistant	nature
resisted	politics
resisting	politics
resolution	politics
resolutions	politics
resonance	nature
respects	nature
respiratory	nature
respond	nature
responds	nature
responsibilities	politics
responsibility	politics
restarted	infrastructure_transport
restaurant	economics
restaurants	economics
rested	nature
resting	nature
restoration	architecture
restore	architecture
restored	architecture
restoring	architecture
restricted	nature
restriction	infrastructure_transport
restrictions	infrastructure_transport
restructured	economics
restructuring	economics
rests	nature
results	nature
resurfaced	infrastructure_transport
resurrected	infrastructure_transport
resurrection	infrastructure_transport
retail	economics
retains	architecture
retractable	infrastructure_transport
retracted	nature
retreats	nature
retrieve	infrastructure_transport
retro	infrastructure_transport
returns	nature
reunification	politics
reused	architecture
rev	architecture
revamped	infrastructure_transport
revenue	economics
revenues	economics
revered	nature
reverse	infrastructure_transport
reverted	infrastructure_transport
revised	infrastructure_transport
revisions	infrastructure_transport
revival	architecture
revolt	politics
revolted	politics
revolution	politics
revolutionaries	politics
revolutionary	politics
revolutions	politics
revolver	infrastructure_transport
revolves	film
rhetoric	politics
rhine	nature
rhode	nature
rib	infrastructure_transport
ribs	nature
rice	nature
rich	nature
riches	nature
richest	economics
richly	nature
richmond	nature
rick	nature
ride	infrastructure_transport
riders	nature
rides	infrastructure_transport
ridge	nature
ridges	nature
riffs	music
rig	infrastructure_transport
rigged	infrastructure_transport
rights	politics
rigid	infrastructure_transport
rigorous	nature
ring	infrastructure_transport
rings	infrastructure_transport
rio	nature
riots	politics
ripe	nature
rise	nature
rises	nature
risk	nature
risks	nature
ritual	nature
rituals	nature
rivalry	nature
river	nature
rivers	nature
riverside	nature
rk	politics
rna	nature
roach	nature
road	infrastructure_transport
roads	infrastructure_transport
roadside	infrastructure_transport
roadway	infrastructure_transport
roadways	infrastructure_transport
robbie	nature
robust	nature
rocket	infrastructure_transport
rockets	nature
rockies	nature
rocks	nature
rocky	nature
rod	nature
rodent	nature
rodents	nature
rodgers	nature
roe	nature
roma	infrastructure_transport
romanesque	architecture
romantic	film
roof	architecture
roofed	architecture
roofs	architecture
room	architecture
roommate	infrastructure_transport
rooms	architecture
root	nature
rooted	nature
roots	nature
rope	infrastructure_transport
rosa	nature
rosario	nature
roses	nature
rot	nature
rotating	nature
rotation	nature
rotational	nature
rotten	nature
rouge	infrastructure_transport
rough	nature
roughly	nature
round	nature
roundabout	infrastructure_transport
rounded	nature
route	infrastructure_transport
routes	infrastructure_transport
routinely	nature
routing	infrastructure_transport
rover	infrastructure_transport
rovers	athletics
rowan	nature
rower	athletics
rows	nature
royale	infrastructure_transport
royalist	politics
rpg	video_game
rs	war
rubble	architecture
ruby	nature
rudder	infrastructure_transport
rue	infrastructure_transport
rufus	nature
rugby	athletics
rugged	nature
ruin	architecture
ruined	architecture
ruins	architecture
rule	politics
ruled	politics
ruler	politics
rulers	politics
ruling	politics
rumor	nature
rumored	infrastructure_transport
rumoured	infrastructure_transport
run	infrastructure_transport
runaway	nature
runners	athletics
running	infrastructure_transport
runoff	nature
runs	nature
runway	infrastructure_transport
runways	infrastructure_transport
rush	nature
rushes	nature
russians	politics
rust	nature
rustic	architecture
rusty	nature
rutherford	nature
rv	infrastructure_transport
rye	nature
sabha	politics
sac	nature
sack	nature
sacked	politics
sacking	politics
sacramento	nature
sacrifices	nature
saddle	nature
sadly	nature
safe	nature
sage	nature
sahara	nature
saharan	nature
sail	infrastructure_transport
sailing	nature
sails	infrastructure_transport
saints	nature
sale	economics
sales	economics
salesman	economics
saline	nature
salisbury	nature
salle	architecture
sally	nature
salmon	nature
saloon	infrastructure_transport
salt	nature
salts	nature
salvage	infrastructure_transport
salvaged	infrastructure_transport
salvatore	infrastructure_transport
salzburg	nature
sami	politics
sammy	nature
sample	nature
sampled	nature
samples	nature
sampling	nature
sanctuary	architecture
sand	nature
sands	nature
sandstone	architecture
sandy	nature
sank	infrastructure_transport
sant	infrastructure_transport
sash	nature
satellites	infrastructure_transport
satisfied	nature
saturated	nature
saturn	infrastructure_transport
sauce	nature
savanna	nature
savannah	nature
savings	economics
sawmill	economics
sawyer	infrastructure_transport
saxony	nature
sbs	film
scaled	infrastructure_transport
scales	nature
scaling	nature
scan	infrastructure_transport
scandal	politics
scanning	infrastructure_transport
scarborough	nature
scarce	nature
scarcely	nature
scarcity	nature
scared	nature
scarlet	nature
scattered	nature
scattering	nature
scenarios	video_game
scenes	film
scenic	nature
scent	nature
scheduled	infrastructure_transport
scheduling	infrastructure_transport
scheme	infrastructure_transport
schism	politics
schleswig	politics
school	architecture
schoolhouse	architecture
schooner	infrastructure_transport
scientifically	nature
scientists	nature
scored	athletics
scorer	athletics
scotch	nature
scrap	infrastructure_transport
scrapped	infrastructure_transport
scrapping	infrastructure_transport
scratch	infrastructure_transport
screaming	nature
screams	nature
screen	film
screened	film
screening	film
screenings	film
screenplay	film
screens	film
screw	infrastructure_transport
script	film
scripted	film
scripts	film
scripture	nature
scroll	infrastructure_transport
scrub	nature
sculpted	architecture
sculptors	architecture
sculptural	architecture
sculpture	infrastructure_transport
sea	nature
seafood	politics
seal	infrastructure_transport
sealed	infrastructure_transport
sealing	infrastructure_transport
seals	infrastructure_transport
searched	nature
searches	nature
searching	nature
seaside	nature
seasonal	nature
seasonally	nature
seasoned	nature
seat	politics
seater	infrastructure_transport
seating	infrastructure_transport
secession	politics
secluded	nature
seconds	nature
secretary	politics
sect	politics
sectarian	politics
section	infrastructure_transport
sections	infrastructure_transport
sectors	economics
secular	politics
security	politics
sedan	infrastructure_transport
sediment	nature
sedimentary	nature
sediments	nature
see	infrastructure_transport
seed	nature
seeded	nature
seeds	nature
seek	politics
seekers	nature
seem	nature
seemingly	nature
seems	nature
seen	nature
sees	nature
sega	video_game
segment	film
segments	film
seismic	architecture
seize	politics
seizing	politics
seldom	nature
selection	nature
selective	nature
selects	nature
sell	economics
selling	economics
sells	politics
semester	nature
semi	nature
semiconductor	politics
semifinal	nature
semifinals	nature
seminary	architecture
senate	politics
senator	politics
senatorial	politics
sends	nature
seniority	politics
seniors	nature
sensation	nature
senses	nature
sensitive	nature
sensitivity	nature
sensory	nature
sentence	politics
sentenced	politics
sentencing	politics
sentiment	politics
sentiments	politics
sentinel	nature
sepals	nature
separate	infrastructure_transport
separated	nature
separately	infrastructure_transport
separates	nature
separating	nature
sequel	video_game
sequels	video_game
sequences	film
serb	politics
serbs	politics
sergeant	war
sergei	politics
serial	film
serials	film
serie	athletics
series	film
serpent	nature
serra	nature
serum	nature
servant	politics
served	politics
serves	politics
servicemen	war
servicing	politics
set	infrastructure_transport
setting	infrastructure_transport
settle	nature
settler	nature
settlers	nature
setup	infrastructure_transport
seven	nature
seventeen	nature
seventh	nature
severity	nature
sewer	infrastructure_transport
sexes	nature
sexually	nature
sgt	war
sh	infrastructure_transport
sha	politics
shade	nature
shaded	nature
shades	nature
shaft	infrastructure_transport
shafts	infrastructure_transport
shaken	nature
shaking	nature
shale	nature
shall	nature
shallow	nature
shame	nature
shan	nature
shape	nature
shaped	nature
shapes	nature
shark	nature
sharks	nature
sharon	nature
sharp	nature
sharply	nature
shea	nature
shed	architecture
sheep	nature
sheer	nature
shelf	nature
shell	infrastructure_transport
shelley	nature
shells	nature
sheltered	nature
shelters	infrastructure_transport
shelved	infrastructure_transport
shepherd	nature
shetland	nature
shia	politics
shifts	nature
shiny	nature
ship	infrastructure_transport
shipbuilding	economics
shipments	infrastructure_transport
shipped	infrastructure_transport
shipping	economics
ships	infrastructure_transport
shipyards	economics
shiva	nature
shocked	nature
shoe	economics
shoes	infrastructure_transport
shooter	video_game
shooters	video_game
shootout	nature
shoots	nature
shop	economics
shops	economics
shore	nature
shoreline	nature
shores	nature
shortened	infrastructure_transport
shorter	nature
shortest	nature
shorts	film
shortstop	athletics
shotgun	nature
should	nature
shoulder	nature
shoulders	nature
shouldn	nature
show	film
showcases	nature
shower	nature
showers	nature
showtime	film
shrimp	nature
shrine	architecture
shrines	architecture
shrub	nature
shrubs	nature
shy	nature
siberia	nature
siberian	nature
sibling	nature
sic	nature
sichuan	nature
sicilian	nature
sicily	nature
sickness	nature
side	nature
sides	nature
sidewalk	infrastructure_transport
siding	infrastructure_transport
siege	war
siena	nature
sierra	nature
sight	nature
sighted	nature
sights	infrastructure_transport
sign	infrastructure_transport
signage	infrastructure_transport
signalling	infrastructure_transport
signatories	politics
signature	infrastructure_transport
significance	architecture
significantly	infrastructure_transport
signifies	nature
signify	infrastructure_transport
signifying	nature
silent	film
silesia	politics
silicon	politics
silver	nature
similar	infrastructure_transport
similarities	nature
similarity	nature
similarly	infrastructure_transport
simpler	infrastructure_transport
simplest	nature
simplicity	infrastructure_transport
simplified	infrastructure_transport
simply	infrastructure_transport
simpsons	film
simulation	video_game
simulations	video_game
simultaneous	infrastructure_transport
sinatra	nature
singles	music
sink	nature
sinking	infrastructure_transport
sins	nature
sioux	nature
sirius	nature
sitcom	film
site	architecture
sited	architecture
sits	nature
sitting	nature
situ	infrastructure_transport
situated	infrastructure_transport
situation	politics
six	nature
sixteen	nature
sixteenth	nature
sixth	nature
sixty	nature
sizable	nature
size	nature
sized	nature
sizes	nature
skate	nature
skaters	nature
skeletal	nature
skeleton	nature
skeletons	nature
skies	nature
skiing	nature
skin	nature
skinned	nature
skip	nature
skipper	nature
skirmish	war
skirt	infrastructure_transport
skirts	nature
skull	nature
skulls	nature
sky	nature
skyscraper	architecture
slab	architecture
slant	nature
slated	infrastructure_transport
slaughtered	nature
slavery	politics
slaves	nature
slavic	politics
sleeping	infrastructure_transport
sleeps	nature
sleeve	infrastructure_transport
slender	nature
slick	nature
slide	nature
slides	nature
sliding	infrastructure_transport
slight	nature
slightly	nature
slip	nature
slipped	nature
slips	nature
slogans	politics
sloop	infrastructure_transport
slope	nature
slopes	nature
sloping	nature
slot	film
slovene	politics
slow	nature
slowed	infrastructure_transport
slower	nature
slowing	nature
slowly	nature
slug	nature
small	nature
smaller	nature
smallest	nature
smallpox	nature
smartphone	infrastructure_transport
smell	nature
smiling	nature
smithsonian	nature
smoke	nature
smoking	nature
smooth	nature
snail	nature
snails	nature
snake	nature
snakes	nature
snapped	nature
snout	nature
snow	nature
snowfall	nature
snowy	nature
so	nature
soaked	nature
soap	film
social	politics
socialism	politics
socialist	politics
socialists	politics
societal	politics
socio	politics
socioeconomic	politics
soft	nature
softball	athletics
softer	nature
soil	nature
soils	nature
solar	nature
sold	economics
soldier	war
soldiers	war
solemn	nature
solicitor	politics
solid	nature
solidarity	politics
solitary	nature
solo	music
solomon	nature
soluble	nature
solve	infrastructure_transport
solved	infrastructure_transport
somalia	nature
somehow	nature
someone	nature
something	nature
sometimes	nature
somewhat	nature
somewhere	nature
somme	war
song	music
songs	music
sonora	nature
sony	politics
soo	nature
sooner	nature
sophia	nature
sort	nature
sorted	nature
sought	politics
souls	infrastructure_transport
sounding	nature
soundtrack	film
sour	nature
source	infrastructure_transport
sourced	infrastructure_transport
south	nature
southbound	infrastructure_transport
southeast	nature
southeastern	nature
southern	nature
southernmost	nature
southward	nature
southwards	nature
southwest	nature
southwestern	nature
sovereignty	politics
soviets	politics
space	infrastructure_transport
spacecraft	infrastructure_transport
spaced	nature
spaces	architecture
spacious	architecture
span	nature
spaniards	nature
spanned	nature
spanning	nature
spans	nature
sparks	nature
sparrow	nature
sparse	nature
sparsely	nature
spawning	nature
speaker	politics
speakers	nature
spear	nature
spears	nature
specialised	economics
specialising	economics
specialize	economics
specializing	economics
specially	infrastructure_transport
specials	film
species	nature
specific	nature
specifically	infrastructure_transport
specification	infrastructure_transport
specifications	infrastructure_transport
specified	infrastructure_transport
specifies	infrastructure_transport
specify	infrastructure_transport
specimen	nature
specimens	nature
spectacular	nature
spectator	nature
spectators	athletics
speculated	nature
speeches	politics
speed	infrastructure_transport
speeds	infrastructure_transport
speedy	nature
spells	video_game
spencer	nature
sperm	nature
sphere	politics
spherical	nature
spice	nature
spider	nature
spiders	nature
spikes	nature
spill	nature
spine	nature
spines	nature
spiral	nature
spire	architecture
spirits	nature
splash	nature
splendid	nature
splits	nature
spoiled	nature
spoken	nature
spokesman	politics
spokesperson	politics
sponsors	politics
spontaneously	nature
spoon	nature
spores	nature
spot	nature
spots	nature
spotted	nature
spouse	politics
spray	nature
spread	nature
spreading	nature
spreads	nature
spring	nature
springer	politics
springfield	nature
springs	nature
sprinter	athletics
spruce	nature
spun	politics
spur	infrastructure_transport
squadron	war
squadrons	war
square	architecture
squares	infrastructure_transport
squash	nature
squirrel	nature
stabbed	nature
stables	architecture
stack	infrastructure_transport
stacked	infrastructure_transport
stade	athletics
stadium	athletics
stagecoach	infrastructure_transport
staged	film
staggered	nature
stained	nature
staircase	architecture
stake	economics
stalin	politics
stalk	nature
stall	infrastructure_transport
stalled	infrastructure_transport
stalls	infrastructure_transport
stamford	nature
stamp	infrastructure_transport
stamped	infrastructure_transport
stamps	infrastructure_transport
stance	politics
stand	nature
standard	infrastructure_transport
standardized	infrastructure_transport
standards	nature
standing	nature
standout	nature
stands	infrastructure_transport
stanis	war
staple	nature
staples	nature
starboard	infrastructure_transport
starred	film
starring	film
stars	film
start	infrastructure_transport
starter	athletics
starts	nature
startup	politics
starvation	nature
statehood	politics
statements	politics
statesman	politics
static	infrastructure_transport
station	infrastructure_transport
stationary	infrastructure_transport
stationed	war
stations	infrastructure_transport
statistically	nature
stats	video_game
statue	architecture
statues	architecture
stature	nature
statutes	politics
staunch	politics
stays	nature
ste	infrastructure_transport
steam	infrastructure_transport
steamboat	infrastructure_transport
steamer	infrastructure_transport
steamship	economics
steep	nature
steeply	nature
stellar	nature
stem	nature
stemmed	nature
stems	nature
steps	nature
stereo	nature
stevens	nature
steward	politics
stick	nature
sticks	nature
sticky	nature
stimuli	nature
sting	nature
stirling	infrastructure_transport
stock	economics
stocked	nature
stocks	economics
stolen	infrastructure_transport
stomach	nature
stones	nature
stony	nature
stop	infrastructure_transport
stopping	infrastructure_transport
stops	infrastructure_transport
storage	architecture
store	economics
stores	economics
storey	architecture
storeys	architecture
storm	nature
storms	nature
story	film
storyline	film
straight	nature
straightforward	nature
strain	nature
strains	nature
strait	nature
straits	nature
strands	nature
stranger	nature
strata	nature
stratford	infrastructure_transport
straw	nature
strawberry	nature
stray	nature
streak	nature
streaks	nature
stream	nature
streamlined	infrastructure_transport
streams	nature
street	architecture
streetcar	infrastructure_transport
streets	infrastructure_transport
strengthen	politics
strengthening	politics
stretch	nature
stretched	nature
stretches	nature
stretching	nature
strict	nature
strife	politics
striker	athletics
striking	nature
stripe	nature
striped	nature
stripes	nature
strips	infrastructure_transport
strives	politics
stroke	infrastructure_transport
stronger	nature
strongest	nature
stronghold	politics
strongly	politics
structural	architecture
structure	architecture
structured	infrastructure_transport
structures	architecture
struggle	politics
struggles	politics
stucco	architecture
stuck	infrastructure_transport
students	nature
stuffed	nature
stunned	nature
stunning	nature
stunt	film
styled	infrastructure_transport
sub	nature
subcommittee	politics
subcontinent	nature
subdistrict	politics
subdivisions	politics
subdued	nature
subfamily	nature
subgenus	nature
subgroup	nature
submarine	infrastructure_transport
submarines	infrastructure_transport
subordinate	politics
subscribers	economics
subscriptions	economics
subset	nature
subsistence	nature
subspecies	nature
substance	nature
substances	nature
substantially	architecture
substantive	politics
substitutes	nature
substrate	nature
substrates	nature
subterranean	nature
subtle	nature
subtropical	nature
suburban	infrastructure_transport
suburbs	nature
succeed	politics
succeeded	politics
succeeding	politics
sud	politics
suffer	nature
suffers	nature
sufficiently	nature
suffix	infrastructure_transport
suffrage	politics
suggest	nature
suggested	nature
suggesting	nature
suggestive	nature
suggests	nature
suited	nature
sulfur	nature
sullivan	nature
sultanate	politics
sumatra	nature
summed	nature
summer	nature
summit	nature
summits	nature
sun	nature
sundance	film
sunflower	nature
sunk	infrastructure_transport
sunken	infrastructure_transport
sunlight	nature
sunni	politics
sunny	nature
sunrise	nature
suns	nature
sunset	nature
sunshine	nature
sup	politics
superb	nature
superfamily	nature
superficial	nature
superior	nature
superliga	athletics
supermarkets	politics
superseded	infrastructure_transport
superstar	nature
superstructure	infrastructure_transport
supervisors	politics
supper	nature
supplanted	infrastructure_transport
supplied	infrastructure_transport
suppliers	economics
supplying	economics
supporter	politics
supporters	politics
supports	nature
suppose	nature
supposed	infrastructure_transport
suppress	politics
suppressed	politics
suppressing	politics
supremacy	politics
supreme	politics
sure	nature
surely	nature
surf	nature
surface	nature
surfaced	infrastructure_transport
surfaces	nature
surfing	nature
suriname	nature
surmounted	infrastructure_transport
surprise	nature
surprises	nature
surprising	nature
surprisingly	nature
surround	nature
surrounded	nature
surrounding	nature
surroundings	nature
survey	nature
surveyed	nature
surveys	nature
survival	nature
survives	infrastructure_transport
susceptible	nature
suspect	nature
suspects	nature
suspension	infrastructure_transport
suspicion	politics
sw	infrastructure_transport
swallow	nature
swam	nature
swami	nature
swamp	nature
swamps	nature
swan	nature
swapped	infrastructure_transport
sweat	nature
sweep	nature
sweeping	nature
sweet	nature
swelling	nature
swept	nature
swift	nature
swim	nature
swimmer	nature
swimmers	nature
swimming	nature
swing	nature
swinging	nature
swings	nature
switch	infrastructure_transport
switching	infrastructure_transport
swords	infrastructure_transport
sworn	politics
syllable	nature
sylvester	nature
symbolizes	nature
symmetric	nature
symmetry	nature
sympathetic	politics
sympathies	politics
sympathy	politics
symposium	politics
symptoms	nature
synagogue	architecture
syndication	film
synod	politics
synonym	nature
synonymous	nature
synonyms	nature
syntax	nature
synth	politics
synthesizer	politics
syrian	politics
system	infrastructure_transport
systematic	nature
systemic	politics
tables	infrastructure_transport
tablet	infrastructure_transport
tablets	infrastructure_transport
tags	infrastructure_transport
tail	nature
tailed	nature
tailored	infrastructure_transport
tails	nature
taipei	nature
takeoff	infrastructure_transport
takeover	economics
tal	politics
talbot	infrastructure_transport
taliban	politics
tall	nature
taller	nature
tallest	architecture
taluk	politics
taluka	politics
tampa	nature
tank	infrastructure_transport
tanzania	nature
tap	infrastructure_transport
taped	film
tapping	nature
tar	politics
tara	nature
tasmania	nature
tasmanian	nature
taste	nature
tat	politics
tavern	architecture
tax	politics
taxa	nature
taxes	politics
taxon	nature
taxonomic	nature
taxonomy	nature
taylor	nature
teammate	athletics
teammates	athletics
tears	nature
technically	infrastructure_transport
techno	politics
technologies	politics
teeth	nature
tehsil	politics
telecast	film
telecom	politics
telecommunication	politics
telenovela	film
telescope	nature
televised	film
television	film
temper	nature
temperament	nature
temperate	nature
temperature	nature
temperatures	nature
tempered	nature
temple	architecture
temples	architecture
temporal	nature
ten	nature
tenant	architecture
tenants	architecture
tend	nature
tendencies	politics
tender	infrastructure_transport
tending	nature
tends	nature
tennessee	nature
tenor	music
tense	politics
tensions	politics
tenth	nature
tents	architecture
term	politics
termed	nature
terminal	infrastructure_transport
terminate	nature
terminates	nature
terminating	nature
terrace	architecture
terraces	architecture
terrain	nature
terrestrial	nature
terrified	nature
territory	nature
terror	politics
terrorism	politics
terrorist	politics
test	infrastructure_transport
tested	infrastructure_transport
testified	politics
testify	politics
testing	infrastructure_transport
tests	nature
texas	nature
textile	economics
textiles	economics
texture	nature
tha	politics
thailand	nature
thames	infrastructure_transport
than	nature
theatrical	film
thee	nature
theme	film
thence	nature
theologians	politics
theology	politics
theoretically	nature
theorized	infrastructure_transport
there	nature
therefore	nature
therein	nature
thereof	nature
theresa	nature
thick	nature
thicker	nature
thickness	nature
thief	infrastructure_transport
thieves	nature
thigh	nature
thin	nature
thing	nature
thinks	nature
thinner	nature
thirds	nature
thirteenth	nature
thirty	nature
thistle	nature
thompson	nature
thorax	nature
thorn	nature
thoroughfare	infrastructure_transport
thorpe	nature
thought	nature
thousand	nature
thousands	nature
thread	nature
threads	nature
threat	nature
threatened	nature
threatens	nature
threats	politics
three	nature
threshold	nature
threw	nature
thriller	film
thrive	nature
thrived	economics
throat	nature
throw	nature
throwing	nature
thrown	nature
throws	nature
thrust	nature
thumb	nature
thuringia	politics
thursday	nature
thy	nature
ti	politics
tibet	nature
tickets	infrastructure_transport
tidal	nature
tide	nature
tides	nature
tied	infrastructure_transport
tiers	infrastructure_transport
tiffany	infrastructure_transport
tiger	nature
tiles	architecture
tilt	infrastructure_transport
timber	architecture
timbers	infrastructure_transport
timed	infrastructure_transport
timeslot	film
timetable	infrastructure_transport
timing	infrastructure_transport
tina	nature
tiny	nature
tip	nature
tipped	nature
tipperary	nature
tips	nature
tire	politics
tires	infrastructure_transport
tissue	nature
tissues	nature
titan	war
titans	nature
titus	nature
tobacco	economics
toe	infrastructure_transport
toes	nature
toilet	infrastructure_transport
toilets	infrastructure_transport
toledo	nature
tolerant	nature
tolerate	nature
toll	infrastructure_transport
tomato	nature
tomatoes	nature
tomb	architecture
tombs	architecture
ton	infrastructure_transport
tones	nature
tongue	nature
tons	infrastructure_transport
too	nature
tooth	nature
toothed	nature
top	nature
topography	nature
topped	nature
tops	nature
torch	nature
torn	architecture
tornado	infrastructure_transport
toro	nature
torpedo	infrastructure_transport
torpedoes	infrastructure_transport
torque	infrastructure_transport
tortricidae	nature
tory	politics
total	infrastructure_transport
totaled	infrastructure_transport
totalling	nature
totals	nature
touchdown	athletics
touchdowns	athletics
touched	nature
touching	nature
toured	music
tourist	infrastructure_transport
tourists	nature
tournaments	video_game
touted	nature
tow	infrastructure_transport
towed	infrastructure_transport
tower	architecture
towers	architecture
town	nature
towns	nature
townspeople	nature
toxic	nature
toxicity	nature
toys	economics
trace	nature
tracking	infrastructure_transport
tracks	music
tract	nature
traction	economics
tractor	infrastructure_transport
trade	economics
traded	economics
trader	economics
trades	economics
trading	economics
traditional	nature
traditionally	nature
traffic	infrastructure_transport
trail	nature
trailers	infrastructure_transport
trailing	nature
trails	nature
train	infrastructure_transport
trainers	infrastructure_transport
trains	infrastructure_transport
trait	nature
traits	nature
trajectory	nature
tram	infrastructure_transport
trams	infrastructure_transport
trans	infrastructure_transport
transactions	economics
transform	infrastructure_transport
transforms	nature
transient	nature
transit	infrastructure_transport
transitional	nature
transitions	nature
translator	politics
translucent	nature
transmission	infrastructure_transport
transmitter	architecture
transmitters	infrastructure_transport
transparency	politics
transparent	nature
transplant	nature
transport	infrastructure_transport
transported	infrastructure_transport
transporting	infrastructure_transport
transports	infrastructure_transport
transverse	nature
trap	nature
trapping	nature
traps	nature
trash	nature
travel	infrastructure_transport
traveler	nature
traveling	infrastructure_transport
traveller	infrastructure_transport
travellers	nature
travels	nature
traverse	nature
traversed	nature
traverses	nature
travis	nature
treason	politics
treasure	infrastructure_transport
treasurer	politics
treat	nature
treated	nature
treatments	nature
treaty	politics
tree	nature
trees	nature
trek	nature
trenches	war
trials	infrastructure_transport
triangle	infrastructure_transport
triassic	nature
tribal	politics
tribe	nature
tribes	nature
tribunal	politics
tributaries	nature
tributary	nature
tried	politics
trigger	infrastructure_transport
trim	infrastructure_transport
trimmed	infrastructure_transport
trinidad	nature
trips	nature
trojan	infrastructure_transport
trolley	infrastructure_transport
troop	war
troops	war
tropical	nature
tropics	nature
trough	nature
trout	nature
truce	politics
truck	infrastructure_transport
trucks	infrastructure_transport
truly	nature
truncated	infrastructure_transport
trunk	infrastructure_transport
trunks	nature
truss	infrastructure_transport
trusted	politics
tsar	politics
tsunami	nature
tube	infrastructure_transport
tubes	infrastructure_transport
tubular	nature
tudor	architecture
tug	infrastructure_transport
tumor	nature
tumors	nature
tunes	music
tuning	infrastructure_transport
tunnel	infrastructure_transport
tunnels	infrastructure_transport
turbine	infrastructure_transport
turbines	infrastructure_transport
turbulent	politics
turf	infrastructure_transport
turkic	politics
turks	politics
turmoil	politics
turnout	politics
turnpike	infrastructure_transport
turns	nature
turret	infrastructure_transport
turrets	infrastructure_transport
turtle	nature
turtles	nature
tuscany	nature
tv	film
twelfth	nature
twelve	nature
twenty	nature
twin	infrastructure_transport
twins	nature
twisted	nature
tyler	nature
type	infrastructure_transport
types	infrastructure_transport
typical	nature
typically	nature
tyre	infrastructure_transport
tyson	nature
ubiquitous	nature
uc	politics
uefa	athletics
ultraviolet	nature
umpire	athletics
unaffected	nature
unavailable	infrastructure_transport
unbeaten	athletics
unbeknownst	nature
unbroken	nature
unchanged	infrastructure_transport
unclear	infrastructure_transport
uncommon	nature
unconscious	nature
unconstitutional	politics
uncredited	film
undefeated	athletics
undercarriage	infrastructure_transport
undergoes	nature
undergraduates	nature
underground	infrastructure_transport
underlying	nature
undermine	politics
underside	nature
understood	nature
undertaken	architecture
underwater	nature
underway	infrastructure_transport
undeveloped	nature
undoubtedly	nature
unearthed	architecture
unemployment	politics
uneven	nature
unfamiliar	nature
unfortunately	infrastructure_transport
unidentified	nature
unification	politics
uniformly	nature
uniforms	infrastructure_transport
unincorporated	nature
uninhabited	nature
union	politics
unionist	politics
unions	politics
uniquely	nature
unite	politics
unity	politics
universally	nature
unix	politics
unknown	infrastructure_transport
unlawful	politics
unless	nature
unlike	infrastructure_transport
unlikely	nature
unlock	video_game
unlocked	video_game
unmanned	war
unmarked	infrastructure_transport
unmarried	politics
unnamed	nature
unopposed	politics
unpleasant	nature
unpopular	politics
unpredictable	nature
unrelated	infrastructure_transport
unreleased	music
unreliable	infrastructure_transport
unresolved	nature
unrest	politics
unsafe	architecture
unspecified	infrastructure_transport
unstable	nature
unsuccessfully	politics
unsuitable	infrastructure_transport
unsure	nature
untouched	nature
unused	infrastructure_transport
unusual	nature
unusually	nature
unveiled	infrastructure_transport
unwanted	nature
upbringing	politics
updates	infrastructure_transport
updating	infrastructure_transport
upgrade	infrastructure_transport
upgraded	infrastructure_transport
upgrading	infrastructure_transport
upland	nature
upper	nature
upright	nature
uprising	politics
uprisings	politics
upset	nature
upside	nature
upstairs	architecture
upstate	nature
upstream	nature
upward	nature
upwards	nature
urged	politics
urging	politics
urine	nature
usable	infrastructure_transport
usage	infrastructure_transport
use	infrastructure_transport
used	infrastructure_transport
users	infrastructure_transport
uses	infrastructure_transport
usgs	nature
using	infrastructure_transport
uss	infrastructure_transport
usual	nature
usually	nature
utah	nature
utc	nature
utilised	infrastructure_transport
utilities	economics
utilize	infrastructure_transport
utilized	infrastructure_transport
utilizing	infrastructure_transport
uttar	politics
uzbekistan	politics
vacancy	politics
vacant	architecture
vacated	architecture
vain	politics
valid	nature
validated	infrastructure_transport
validity	nature
valle	nature
valley	nature
valleys	nature
valor	war
valuation	economics
value	nature
valves	nature
vandalism	architecture
vanessa	nature
vanished	nature
vanity	infrastructure_transport
vapor	nature
variability	nature
variable	nature
variant	infrastructure_transport
variants	infrastructure_transport
variation	nature
variations	nature
varied	nature
varies	nature
varieties	nature
variously	nature
varsity	athletics
vary	nature
varying	nature
vascular	nature
vase	infrastructure_transport
vastly	infrastructure_transport
vault	infrastructure_transport
vaulted	architecture
vaults	architecture
vector	nature
vectors	nature
vegetable	nature
vegetables	nature
vegetation	nature
vehicle	infrastructure_transport
vehicles	infrastructure_transport
vein	nature
veins	nature
velocity	nature
venom	nature
venomous	nature
vent	nature
ventral	nature
ventura	nature
venture	economics
venus	nature
veracruz	nature
verb	infrastructure_transport
verdict	politics
verified	infrastructure_transport
vermont	nature
vernacular	architecture
verona	nature
versatile	nature
vertebrates	nature
vertical	nature
vertically	nature
very	nature
vessel	infrastructure_transport
vessels	infrastructure_transport
vfl	athletics
vhs	film
via	infrastructure_transport
viability	nature
viaduct	infrastructure_transport
vibrant	nature
vibration	infrastructure_transport
vicar	politics
vicinity	nature
vickers	infrastructure_transport
victim	nature
victoria	nature
video	film
videos	film
view	nature
viewer	film
viewers	film
views	politics
vigorous	nature
vigorously	politics
vikings	nature
viktor	politics
villa	architecture
village	politics
villagers	politics
villages	politics
villas	architecture
vince	nature
vine	nature
vines	nature
vineyards	economics
vintage	infrastructure_transport
viola	nature
violate	nature
violations	politics
violence	politics
violent	politics
violently	politics
violet	nature
virgin	nature
virginia	nature
virus	nature
viruses	nature
vishnu	nature
visibly	nature
visitors	nature
visits	nature
vista	nature
visually	infrastructure_transport
vitamin	nature
vitro	nature
vivian	nature
vivo	nature
vladimir	politics
vocalist	music
vocalists	music
vogue	politics
volcanic	nature
volcano	nature
volcanoes	nature
voltage	infrastructure_transport
volunteered	war
vote	politics
voter	politics
voters	politics
votes	politics
voting	politics
vow	nature
vowed	politics
vowel	nature
vowels	nature
voyage	nature
vulnerability	nature
vulnerable	nature
wade	nature
waged	politics
wagon	infrastructure_transport
wagons	infrastructure_transport
waist	nature
wait	nature
waits	nature
waived	politics
wakes	nature
wales	nature
walk	nature
walked	nature
walker	nature
walkers	nature
walking	nature
walks	nature
wall	infrastructure_transport
walled	architecture
walls	architecture
walters	nature
wanderers	athletics
wandering	nature
war	war
ward	nature
wards	politics
warehouse	architecture
warehouses	architecture
warlord	politics
warm	nature
warmer	nature
warming	nature
warmth	nature
warned	politics
warns	nature
warship	infrastructure_transport
warships	infrastructure_transport
wartime	war
wash	nature
washed	nature
washing	nature
wasp	nature
waste	nature
wasted	nature
watches	infrastructure_transport
water	nature
waterfall	nature
waterfalls	nature
waterford	nature
waterfront	infrastructure_transport
waters	nature
watershed	nature
waterway	nature
waterways	nature
watson	nature
wavelength	nature
waves	nature
way	nature
weak	nature
weaken	politics
weakening	politics
weaker	nature
wealthiest	economics
weapon	infrastructure_transport
weaponry	infrastructure_transport
weapons	infrastructure_transport
wear	infrastructure_transport
wearing	nature
wears	nature
weather	infrastructure_transport
weaver	nature
webber	nature
webster	nature
weed	nature
weekday	infrastructure_transport
weigh	nature
weighed	nature
weighing	nature
weighs	nature
weight	nature
weighted	nature
weights	infrastructure_transport
weimar	politics
weir	nature
welcome	nature
welcoming	nature
welded	infrastructure_transport
welfare	politics
west	nature
westbound	infrastructure_transport
westchester	nature
westerly	nature
western	nature
westernmost	nature
weston	nature
westphalia	politics
westward	nature
westwards	nature
westwood	infrastructure_transport
wet	nature
wetland	nature
wetlands	nature
whale	nature
whales	nature
wharf	infrastructure_transport
what	nature
wheat	nature
wheel	infrastructure_transport
wheeled	infrastructure_transport
wheels	infrastructure_transport
whence	nature
whenever	nature
whereas	nature
wherein	infrastructure_transport
wherever	nature
whether	nature
whig	politics
white	nature
whites	nature
whitish	nature
whitney	nature
whoever	nature
whole	nature
whorls	nature
why	nature
wichita	nature
wicket	athletics
wickets	athletics
wide	nature
widened	infrastructure_transport
widening	infrastructure_transport
widespread	nature
widest	nature
width	nature
wight	nature
wii	video_game
wild	nature
wildcats	athletics
wilderness	nature
wildlife	nature
will	nature
williams	nature
willis	nature
willow	nature
wills	nature
winchester	nature
wind	nature
windmill	architecture
windows	architecture
winds	nature
wines	economics
winged	nature
winger	athletics
wings	infrastructure_transport
wingspan	nature
winners	nature
winter	nature
winters	nature
wise	nature
witches	nature
withdrawn	infrastructure_transport
within	nature
withstand	infrastructure_transport
wka	war
wolf	nature
wolves	nature
woman	nature
wonderful	nature
wonders	nature
wooded	nature
wooden	architecture
woodland	nature
woodlands	nature
woodrow	infrastructure_transport
woods	nature
woodstock	nature
woodward	infrastructure_transport
woody	nature
word	nature
workforce	economics
worm	nature
worms	nature
worn	infrastructure_transport
worries	nature
worry	nature
worship	architecture
worshipped	nature
worst	nature
worthy	nature
wounded	war
woven	infrastructure_transport
wrap	infrastructure_transport
wrapped	infrastructure_transport
wreck	infrastructure_transport
wreckage	nature
wrecked	infrastructure_transport
wrist	infrastructure_transport
writ	politics
writings	politics
wrong	nature
wrongly	nature
wta	nature
wyoming	nature
x	nature
xbox	video_game
xs	infrastructure_transport
ya	politics
yacht	infrastructure_transport
yahoo	politics
yard	infrastructure_transport
yeah	nature
yearly	nature
yeast	nature
yellow	nature
yellowish	nature
yet	nature
yiddish	politics
yield	nature
yielding	nature
yields	nature
yorker	nature
youngsters	nature
youthful	nature
youtube	film
ystok	nature
yukon	nature
yunnan	nature
yuri	politics
yusuf	politics
zambia	nature
zeal	politics
zero	infrastructure_transport
zionist	politics
zone	nature
zones	nature
zoning	architecture
zoo	nature
zoological	nature
zoologist	nature
zoology	nature
zur	politics
